SELECT count(*) FROM singer	concert_singer	How many singers do we have?
SELECT name ,  country ,  age FROM singer ORDER BY age DESC	concert_singer	Show name, country, age for all singers ordered by age from the oldest to the youngest.
SELECT avg(age) ,  min(age) ,  max(age) FROM singer WHERE country  =  'France'	concert_singer	What is the average, minimum, and maximum age of all singers from France?
SELECT song_name ,  song_release_year FROM singer ORDER BY age LIMIT 1	concert_singer	Show the name and the release year of the song by the youngest singer.
SELECT DISTINCT country FROM singer WHERE age  >  20	concert_singer	What are all distinct countries where singers above age 20 are from?
SELECT country ,  count(*) FROM singer GROUP BY country	concert_singer	Show all countries and the number of singers in each country.
SELECT song_name FROM singer WHERE age  >  (SELECT avg(age) FROM singer)	concert_singer	List all song names by singers above the average age.
SELECT LOCATION ,  name FROM stadium WHERE capacity BETWEEN 5000 AND 10000	concert_singer	Show location and name for all stadiums with a capacity between 5000 and 10000.
SELECT avg(capacity) ,  max(capacity) FROM stadium	concert_singer	What is the average and the maximum capacity of all stadiums?
SELECT name ,  capacity FROM stadium ORDER BY average DESC LIMIT 1	concert_singer	What is the name and capacity for the stadium with highest average attendance?
SELECT count(*) FROM concert WHERE YEAR  =  2014 OR YEAR  =  2015	concert_singer	How many concerts are there in year 2014 or 2015?
SELECT T2.name ,  count(*) FROM concert AS T1 JOIN stadium AS T2 ON T1.stadium_id  =  T2.stadium_id GROUP BY T2.name	concert_singer	Show the stadium name and the number of concerts in each stadium.
SELECT T2.name ,  T2.capacity FROM concert AS T1 JOIN stadium AS T2 ON T1.stadium_id  =  T2.stadium_id WHERE T1.year  >=  2014 GROUP BY T2.stadium_id ORDER BY count(*) DESC LIMIT 1	concert_singer	Show the stadium name and capacity with most number of concerts in year 2014 or after.
SELECT YEAR FROM concert GROUP BY YEAR ORDER BY count(*) DESC LIMIT 1	concert_singer	Which year has most number of concerts?
SELECT name FROM stadium WHERE stadium_id NOT IN (SELECT stadium_id FROM concert)	concert_singer	Show the stadium names without any concert.
SELECT country FROM singer WHERE age  >  40 INTERSECT SELECT country FROM singer WHERE age  <  30	concert_singer	Show countries where a singer above age 40 and a singer below 30 are from.
SELECT name FROM stadium EXCEPT SELECT T2.name FROM concert AS T1 JOIN stadium AS T2 ON T1.stadium_id  =  T2.stadium_id WHERE T1.year  =  2014	concert_singer	Show names for all stadiums except for stadiums having a concert in year 2014.
SELECT T2.concert_name ,  T2.theme ,  count(*) FROM singer_in_concert AS T1 JOIN concert AS T2 ON T1.concert_id  =  T2.concert_id GROUP BY T2.concert_id	concert_singer	Show the name and theme for all concerts and the number of singers in each concert.
SELECT T2.name ,  count(*) FROM singer_in_concert AS T1 JOIN singer AS T2 ON T1.singer_id  =  T2.singer_id GROUP BY T2.singer_id	concert_singer	List singer names and number of concerts for each singer.
SELECT T2.name FROM singer_in_concert AS T1 JOIN singer AS T2 ON T1.singer_id  =  T2.singer_id JOIN concert AS T3 ON T1.concert_id  =  T3.concert_id WHERE T3.year  =  2014	concert_singer	List all singer names in concerts in year 2014.
SELECT name ,  country FROM singer WHERE song_name LIKE '%Hey%'	concert_singer	what is the name and nation of the singer who have a song having 'Hey' in its name?
SELECT T2.name ,  T2.location FROM concert AS T1 JOIN stadium AS T2 ON T1.stadium_id  =  T2.stadium_id WHERE T1.Year  =  2014 INTERSECT SELECT T2.name ,  T2.location FROM concert AS T1 JOIN stadium AS T2 ON T1.stadium_id  =  T2.stadium_id WHERE T1.Year  =  2015	concert_singer	Find the name and location of the stadiums which some concerts happened in the years of both 2014 and 2015.
SELECT count(*) FROM concert AS T1 JOIN stadium AS T2 ON T1.stadium_id  =  T2.stadium_id GROUP BY T2.Capacity ORDER BY T2.Capacity DESC LIMIT 1	concert_singer	Find the number of concerts happened in the stadium with the highest capacity.
SELECT count(*) FROM pets WHERE weight  >  10	pets_1	Find the number of pets whose weight is heavier than 10.
SELECT weight FROM pets ORDER BY pet_age LIMIT 1	pets_1	Find the weight of the youngest dog.
SELECT max(weight) ,  petType FROM pets GROUP BY petType	pets_1	Find the maximum weight for each type of pet. List the maximum weight and pet type.
SELECT count(*) FROM student AS T1 JOIN has_pet AS T2 ON T1.stuid  =  T2.stuid WHERE T1.age  >  20	pets_1	Find number of pets owned by students who are older than 20.
SELECT count(*) FROM student AS T1 JOIN has_pet AS T2 ON T1.stuid  =  T2.stuid JOIN pets AS T3 ON T2.petid  =  T3.petid WHERE T1.sex  =  'F' AND T3.pettype  =  'dog'	pets_1	Find the number of dog pets that are raised by female students (with sex F).
SELECT count(DISTINCT pettype) FROM pets	pets_1	Find the number of distinct type of pets.
SELECT DISTINCT T1.Fname FROM student AS T1 JOIN has_pet AS T2 ON T1.stuid  =  T2.stuid JOIN pets AS T3 ON T3.petid  =  T2.petid WHERE T3.pettype  =  'cat' OR T3.pettype  =  'dog'	pets_1	Find the first name of students who have cat or dog pet.
SELECT T1.Fname FROM student AS T1 JOIN has_pet AS T2 ON T1.stuid  =  T2.stuid JOIN pets AS T3 ON T3.petid  =  T2.petid WHERE T3.pettype  =  'cat' INTERSECT SELECT T1.Fname FROM student AS T1 JOIN has_pet AS T2 ON T1.stuid  =  T2.stuid JOIN pets AS T3 ON T3.petid  =  T2.petid WHERE T3.pettype  =  'dog'	pets_1	Find the name of students who have both cat and dog pets.
SELECT major ,  age FROM student WHERE stuid NOT IN (SELECT T1.stuid FROM student AS T1 JOIN has_pet AS T2 ON T1.stuid  =  T2.stuid JOIN pets AS T3 ON T3.petid  =  T2.petid WHERE T3.pettype  =  'cat')	pets_1	Find the major and age of students who do not have a cat pet.
SELECT stuid FROM student EXCEPT SELECT T1.stuid FROM student AS T1 JOIN has_pet AS T2 ON T1.stuid  =  T2.stuid JOIN pets AS T3 ON T3.petid  =  T2.petid WHERE T3.pettype  =  'cat'	pets_1	Find the id of students who do not have a cat pet.
SELECT T1.fname ,  T1.age FROM student AS T1 JOIN has_pet AS T2 ON T1.stuid  =  T2.stuid JOIN pets AS T3 ON T3.petid  =  T2.petid WHERE T3.pettype  =  'dog' AND T1.stuid NOT IN (SELECT T1.stuid FROM student AS T1 JOIN has_pet AS T2 ON T1.stuid  =  T2.stuid JOIN pets AS T3 ON T3.petid  =  T2.petid WHERE T3.pettype  =  'cat')	pets_1	Find the first name and age of students who have a dog but do not have a cat as a pet.
SELECT pettype ,  weight FROM pets ORDER BY pet_age LIMIT 1	pets_1	Find the type and weight of the youngest pet.
SELECT petid ,  weight FROM pets WHERE pet_age  >  1	pets_1	Find the id and weight of all pets whose age is older than 1.
SELECT avg(pet_age) ,  max(pet_age) ,  pettype FROM pets GROUP BY pettype	pets_1	Find the average and maximum age for each type of pet.
SELECT avg(weight) ,  pettype FROM pets GROUP BY pettype	pets_1	Find the average weight for each pet type.
SELECT DISTINCT T1.fname ,  T1.age FROM student AS T1 JOIN has_pet AS T2 ON T1.stuid  =  T2.stuid	pets_1	Find the first name and age of students who have a pet.
SELECT T2.petid FROM student AS T1 JOIN has_pet AS T2 ON T1.stuid  =  T2.stuid WHERE T1.Lname  =  'Smith'	pets_1	Find the id of the pet owned by student whose last name is ‘Smith’.
SELECT count(*) ,  T1.stuid FROM student AS T1 JOIN has_pet AS T2 ON T1.stuid  =  T2.stuid GROUP BY T1.stuid	pets_1	Find the number of pets for each student who has any pet and student id.
SELECT T1.fname ,  T1.sex FROM student AS T1 JOIN has_pet AS T2 ON T1.stuid  =  T2.stuid GROUP BY T1.stuid HAVING count(*)  >  1	pets_1	Find the first name and gender of student who have more than one pet.
SELECT T1.lname FROM student AS T1 JOIN has_pet AS T2 ON T1.stuid  =  T2.stuid JOIN pets AS T3 ON T3.petid  =  T2.petid WHERE T3.pet_age  =  3 AND T3.pettype  =  'cat'	pets_1	Find the last name of the student who has a cat that is age 3.
SELECT avg(age) FROM student WHERE stuid NOT IN (SELECT T1.stuid FROM student AS T1 JOIN has_pet AS T2 ON T1.stuid  =  T2.stuid)	pets_1	Find the average age of students who do not have any pet.
SELECT count(*) FROM CONTINENTS;	car_1	How many continents are there?
SELECT T1.ContId ,  T1.Continent ,  count(*) FROM CONTINENTS AS T1 JOIN COUNTRIES AS T2 ON T1.ContId  =  T2.Continent GROUP BY T1.ContId;	car_1	How many countries does each continent have? List the continent id, continent name and the number of countries.
SELECT count(*) FROM COUNTRIES;	car_1	How many countries are listed?
SELECT T1.FullName ,  T1.Id ,  count(*) FROM CAR_MAKERS AS T1 JOIN MODEL_LIST AS T2 ON T1.Id  =  T2.Maker GROUP BY T1.Id;	car_1	How many models does each car maker produce? List maker full name, id and the number.
SELECT T1.Model FROM CAR_NAMES AS T1 JOIN CARS_DATA AS T2 ON T1.MakeId  =  T2.Id ORDER BY T2.horsepower ASC LIMIT 1;	car_1	Which model of the car has the minimum horsepower?
SELECT T1.model FROM CAR_NAMES AS T1 JOIN CARS_DATA AS T2 ON T1.MakeId  =  T2.Id WHERE T2.Weight  <  (SELECT avg(Weight) FROM CARS_DATA)	car_1	Find the model of the car whose weight is below the average weight.
SELECT DISTINCT T1.Maker FROM CAR_MAKERS AS T1 JOIN MODEL_LIST AS T2 ON T1.Id  =  T2.Maker JOIN CAR_NAMES AS T3 ON T2.model  =  T3.model JOIN CARS_DATA AS T4 ON T3.MakeId  =  T4.id WHERE T4.year  =  '1970';	car_1	Find the name of the makers that produced some cars in the year of 1970?
SELECT T2.Make ,  T1.Year FROM CARS_DATA AS T1 JOIN CAR_NAMES AS T2 ON T1.Id  =  T2.MakeId WHERE T1.Year  =  (SELECT min(YEAR) FROM CARS_DATA);	car_1	Find the make and production time of the cars that were produced in the earliest year?
SELECT DISTINCT T1.model FROM MODEL_LIST AS T1 JOIN CAR_NAMES AS T2 ON T1.model  =  T2.model JOIN CARS_DATA AS T3 ON T2.MakeId  =  T3.id WHERE T3.year  >  1980;	car_1	Which distinct car models are the produced after 1980?
SELECT T1.Continent ,  count(*) FROM CONTINENTS AS T1 JOIN COUNTRIES AS T2 ON T1.ContId  =  T2.continent JOIN car_makers AS T3 ON T2.CountryId  =  T3.Country GROUP BY T1.Continent;	car_1	How many car makers are there in each continents? List the continent name and the count.
SELECT T2.CountryName FROM CAR_MAKERS AS T1 JOIN COUNTRIES AS T2 ON T1.Country  =  T2.CountryId GROUP BY T2.CountryName ORDER BY Count(*) DESC LIMIT 1;	car_1	Which of the countries has the most car makers? List the country name.
SELECT Count(*) ,  T2.FullName ,  T2.id FROM MODEL_LIST AS T1 JOIN CAR_MAKERS AS T2 ON T1.Maker  =  T2.Id GROUP BY T2.id;	car_1	How many car models are produced by each maker? List the count and the maker full name.
SELECT T1.Accelerate FROM CARS_DATA AS T1 JOIN CAR_NAMES AS T2 ON T1.Id  =  T2.MakeId WHERE T2.Make  =  'amc hornet sportabout (sw)';	car_1	What is the accelerate of the car make amc hornet sportabout (sw)?
SELECT count(*) FROM CAR_MAKERS AS T1 JOIN COUNTRIES AS T2 ON T1.Country  =  T2.CountryId WHERE T2.CountryName  =  'france';	car_1	How many car makers are there in france?
SELECT count(*) FROM MODEL_LIST AS T1 JOIN CAR_MAKERS AS T2 ON T1.Maker  =  T2.Id JOIN COUNTRIES AS T3 ON T2.Country  =  T3.CountryId WHERE T3.CountryName  =  'usa';	car_1	How many car models are produced in the usa?
SELECT avg(mpg) FROM CARS_DATA WHERE Cylinders  =  4;	car_1	What is the average miles per gallon(mpg) of the cars with 4 cylinders?
SELECT Weight FROM CARS_DATA WHERE Cylinders  =  4 AND YEAR  =  1974 ORDER BY Weight ASC LIMIT 1;	car_1	What is the smallest weight of the car produced with 4 cylinders on 1974?
SELECT Maker ,  Model FROM MODEL_LIST;	car_1	What are all the makers and models?
SELECT T1.CountryName ,  T1.CountryId FROM COUNTRIES AS T1 JOIN CAR_MAKERS AS T2 ON T1.CountryId  =  T2.Country GROUP BY T1.CountryId HAVING count(*)  >=  1;	car_1	What are the countries having at least one car maker? List name and id.
SELECT count(*) FROM CARS_DATA WHERE horsepower  >  150;	car_1	What is the number of the cars with horsepower more than 150?
SELECT avg(Weight) ,  YEAR FROM CARS_DATA GROUP BY YEAR;	car_1	What is the average weight of cars each year?
SELECT T1.CountryName FROM COUNTRIES AS T1 JOIN CONTINENTS AS T2 ON T1.Continent  =  T2.ContId JOIN CAR_MAKERS AS T3 ON T1.CountryId  =  T3.Country WHERE T2.Continent  =  'europe' GROUP BY T1.CountryName HAVING count(*)  >=  3;	car_1	Which countries in europe have at least 3 car manufacturers?
SELECT T2.horsepower ,  T1.Make FROM CAR_NAMES AS T1 JOIN CARS_DATA AS T2 ON T1.MakeId  =  T2.Id WHERE T2.cylinders  =  3 ORDER BY T2.horsepower DESC LIMIT 1;	car_1	What is the maximum horsepower and the make of the car models with 3 cylinders?
SELECT T1.Model FROM CAR_NAMES AS T1 JOIN CARS_DATA AS T2 ON T1.MakeId  =  T2.Id ORDER BY T2.mpg DESC LIMIT 1;	car_1	Which model saves the most gasoline? That is to say, have the maximum miles per gallon.
SELECT avg(horsepower) FROM CARS_DATA WHERE YEAR  <  1980;	car_1	What is the average horsepower of the cars before 1980?
SELECT avg(T2.edispl) FROM CAR_NAMES AS T1 JOIN CARS_DATA AS T2 ON T1.MakeId  =  T2.Id WHERE T1.Model  =  'volvo';	car_1	What is the average edispl of the cars of model volvo?
SELECT max(Accelerate) ,  Cylinders FROM CARS_DATA GROUP BY Cylinders;	car_1	What is the maximum accelerate for different number of cylinders?
SELECT Model FROM CAR_NAMES GROUP BY Model ORDER BY count(*) DESC LIMIT 1;	car_1	Which model has the most version(make) of cars?
SELECT count(*) FROM CARS_DATA WHERE Cylinders  >  4;	car_1	How many cars have more than 4 cylinders?
SELECT count(*) FROM CARS_DATA WHERE YEAR  =  1980;	car_1	how many cars were produced in 1980?
SELECT count(*) FROM CAR_MAKERS AS T1 JOIN MODEL_LIST AS T2 ON T1.Id  =  T2.Maker WHERE T1.FullName  =  'American Motor Company';	car_1	How many car models were produced by the maker with full name American Motor Company?
SELECT T1.FullName ,  T1.Id FROM CAR_MAKERS AS T1 JOIN MODEL_LIST AS T2 ON T1.Id  =  T2.Maker GROUP BY T1.Id HAVING count(*)  >  3;	car_1	Which makers designed more than 3 car models? List full name and the id.
SELECT DISTINCT T2.Model FROM CAR_NAMES AS T1 JOIN MODEL_LIST AS T2 ON T1.Model  =  T2.Model JOIN CAR_MAKERS AS T3 ON T2.Maker  =  T3.Id JOIN CARS_DATA AS T4 ON T1.MakeId  =  T4.Id WHERE T3.FullName  =  'General Motors' OR T4.weight  >  3500;	car_1	Which distinctive models are produced by maker with the full name General Motors or weighing more than 3500?
SELECT DISTINCT T1.Year FROM CARS_DATA AS T1 WHERE T1.Weight  >  3000 AND T1.weight  <  4000;	car_1	In which years cars were produced weighing no less than 3000 and no more than 4000?
SELECT T1.horsepower FROM CARS_DATA AS T1 ORDER BY T1.accelerate DESC LIMIT 1;	car_1	What is the horsepower of the car with the largest accelerate?
SELECT T1.cylinders FROM CARS_DATA AS T1 JOIN CAR_NAMES AS T2 ON T1.Id  =  T2.MakeId WHERE T2.Model  =  'volvo' ORDER BY T1.accelerate ASC LIMIT 1;	car_1	For model volvo, how many cylinders does the car with the least accelerate have?
SELECT COUNT(*) FROM CARS_DATA WHERE Accelerate  >  ( SELECT Accelerate FROM CARS_DATA ORDER BY Horsepower DESC LIMIT 1 );	car_1	How many cars have a larger accelerate than the car with the largest horsepower?
SELECT COUNT(*) FROM ( SELECT T1.CountryId ,  COUNT(*) FROM COUNTRIES AS T1 JOIN CAR_MAKERS AS T2 ON T1.CountryId  =  T2.Country GROUP BY T1.CountryId HAVING count(*)  >  2 ) as sub;	car_1	How many countries has more than 2 car makers?
SELECT COUNT(*) FROM CARS_DATA WHERE Cylinders  >  6;	car_1	How many cars has over 6 cylinders?
SELECT T1.Model FROM CAR_NAMES AS T1 JOIN CARS_DATA AS T2 ON T1.MakeId  =  T2.Id WHERE T2.Cylinders  =  4 ORDER BY T2.horsepower DESC LIMIT 1;	car_1	For the cars with 4 cylinders, which model has the largest horsepower?
SELECT T2.MakeId ,  T2.Make FROM CARS_DATA AS T1 JOIN CAR_NAMES AS T2 ON T1.Id  =  T2.MakeId WHERE T1.Horsepower  >  (SELECT min(Horsepower) FROM CARS_DATA) AND T1.Cylinders  <=  3;	car_1	Among the cars with more than lowest horsepower, which ones do not have more than 3 cylinders? List the car makeid and make name.
SELECT T2.MakeId ,  T2.Make FROM CARS_DATA AS T1 JOIN CAR_NAMES AS T2 ON T1.Id  =  T2.MakeId WHERE T1.Horsepower  >  (SELECT min(Horsepower) FROM CARS_DATA) AND T1.Cylinders  <  4;	car_1	Among the cars that do not have the minimum horsepower, what are the make ids and names of al those with less than 4 cylinders?
SELECT mpg FROM CARS_DATA WHERE Cylinders  =  8 OR YEAR  <  1980 ORDER BY mpg DESC LIMIT 1;	car_1	What is the maximum miles per gallon of the car with 8 cylinders or produced before 1980?
SELECT DISTINCT T1.model FROM MODEL_LIST AS T1 JOIN CAR_NAMES AS T2 ON T1.Model  =  T2.Model JOIN CARS_DATA AS T3 ON T2.MakeId  =  T3.Id JOIN CAR_MAKERS AS T4 ON T1.Maker  =  T4.Id WHERE T3.weight  <  3500 AND T4.FullName != 'Ford Motor Company';	car_1	Which models are lighter than 3500 but not built by the 'Ford Motor Company'?
SELECT CountryName FROM countries EXCEPT SELECT T1.CountryName FROM countries AS T1 JOIN CAR_MAKERS AS T2 ON T1.countryId  =  T2.Country;	car_1	What are the name of the countries where there is not a single car maker?
SELECT T1.Id ,  T1.Maker FROM CAR_MAKERS AS T1 JOIN MODEL_LIST AS T2 ON T1.Id  =  T2.Maker GROUP BY T1.Id HAVING count(*)  >=  2 INTERSECT SELECT T1.Id ,  T1.Maker FROM CAR_MAKERS AS T1 JOIN MODEL_LIST AS T2 ON T1.Id  =  T2.Maker JOIN CAR_NAMES AS T3 ON T2.model  =  T3.model GROUP BY T1.Id,  T1.Maker HAVING count(*)  >  3;	car_1	Which are the car makers which produce at least 2 models and more than 3 car makes? List the id and the maker.
SELECT T1.countryId ,  T1.CountryName FROM Countries AS T1 JOIN CAR_MAKERS AS T2 ON T1.CountryId  =  T2.Country GROUP BY T1.countryId HAVING count(*)  >  3 UNION SELECT T1.countryId ,  T1.CountryName FROM Countries AS T1 JOIN CAR_MAKERS AS T2 ON T1.CountryId  =  T2.Country JOIN MODEL_LIST AS T3 ON T2.Id  =  T3.Maker WHERE T3.Model  =  'fiat';	car_1	What are the id and names of the countries which have more than 3 car makers or produce the 'fiat' model?
SELECT Country FROM AIRLINES WHERE Airline  =  'JetBlue Airways'	flight_2	Which country does Airline 'JetBlue Airways' belong to?
SELECT Abbreviation FROM AIRLINES WHERE Airline  =  'JetBlue Airways'	flight_2	What is the abbreviation of Airline 'JetBlue Airways'?
SELECT Airline ,  Abbreviation FROM AIRLINES WHERE Country  =  'USA'	flight_2	List all airline names and their abbreviations in 'USA'.
SELECT AirportCode ,  AirportName FROM AIRPORTS WHERE city  =  'Anthony'	flight_2	List the airport code and name in the city of Anthony.
SELECT count(*) FROM AIRLINES	flight_2	How many airlines do we have?
SELECT count(*) FROM AIRPORTS	flight_2	How many airports do we have?
SELECT count(*) FROM FLIGHTS	flight_2	How many flights do we have?
SELECT Airline FROM AIRLINES WHERE Abbreviation  =  'UAL'	flight_2	Which airline has abbreviation 'UAL'?
SELECT count(*) FROM AIRLINES WHERE Country  =  'USA'	flight_2	How many airlines are from USA?
SELECT City ,  Country FROM AIRPORTS WHERE AirportName  =  'Alton'	flight_2	Which city and country is the Alton airport at?
SELECT AirportName FROM AIRPORTS WHERE AirportCode  =  'AKO'	flight_2	What is the airport name for airport 'AKO'?
SELECT AirportName FROM AIRPORTS WHERE City = 'Aberdeen'	flight_2	What are airport names at City 'Aberdeen'?
SELECT count(*) FROM FLIGHTS WHERE SourceAirport  =  'APG'	flight_2	How many flights depart from 'APG'?
SELECT count(*) FROM FLIGHTS WHERE DestAirport  =  'ATO'	flight_2	How many flights have destination ATO?
SELECT count(*) FROM FLIGHTS AS T1 JOIN AIRPORTS AS T2 ON T1.SourceAirport  =  T2.AirportCode WHERE T2.City  =  'Aberdeen'	flight_2	How many flights depart from City Aberdeen?
SELECT count(*) FROM FLIGHTS AS T1 JOIN AIRPORTS AS T2 ON T1.DestAirport  =  T2.AirportCode WHERE T2.City  =  'Aberdeen'	flight_2	How many flights arriving in Aberdeen city?
SELECT count(*) FROM FLIGHTS AS T1 JOIN AIRPORTS AS T2 ON T1.DestAirport  =  T2.AirportCode JOIN AIRPORTS AS T3 ON T1.SourceAirport  =  T3.AirportCode WHERE T2.City  =  'Ashley' AND T3.City  =  'Aberdeen'	flight_2	How many flights depart from City 'Aberdeen' and have destination City 'Ashley'?
SELECT count(*) FROM FLIGHTS AS T1 JOIN AIRLINES AS T2 ON T1.Airline  =  T2.uid WHERE T2.Airline = 'JetBlue Airways'	flight_2	How many flights does airline 'JetBlue Airways' have?
SELECT count(*) FROM AIRLINES AS T1 JOIN FLIGHTS AS T2 ON T2.Airline  =  T1.uid WHERE T1.Airline  =  'United Airlines' AND T2.DestAirport  =  'ASY'	flight_2	How many 'United Airlines' flights go to Airport 'ASY'?
SELECT count(*) FROM AIRLINES AS T1 JOIN FLIGHTS AS T2 ON T2.Airline  =  T1.uid WHERE T1.Airline  =  'United Airlines' AND T2.SourceAirport  =  'AHD'	flight_2	How many 'United Airlines' flights depart from Airport 'AHD'?
SELECT count(*) FROM FLIGHTS AS T1 JOIN AIRPORTS AS T2 ON T1.DestAirport  =  T2.AirportCode JOIN AIRLINES AS T3 ON T3.uid  =  T1.Airline WHERE T2.City  =  'Aberdeen' AND T3.Airline  =  'United Airlines'	flight_2	How many United Airlines flights go to City 'Aberdeen'?
SELECT T1.City FROM AIRPORTS AS T1 JOIN FLIGHTS AS T2 ON T1.AirportCode  =  T2.DestAirport GROUP BY T1.City ORDER BY count(*) DESC LIMIT 1	flight_2	Which city has most number of arriving flights?
SELECT T1.City FROM AIRPORTS AS T1 JOIN FLIGHTS AS T2 ON T1.AirportCode  =  T2.SourceAirport GROUP BY T1.City ORDER BY count(*) DESC LIMIT 1	flight_2	Which city has most number of departing flights?
SELECT T1.AirportCode FROM AIRPORTS AS T1 JOIN FLIGHTS AS T2 ON T1.AirportCode  =  T2.DestAirport OR T1.AirportCode  =  T2.SourceAirport GROUP BY T1.AirportCode ORDER BY count(*) DESC LIMIT 1	flight_2	What is the code of airport that has the highest number of flights?
SELECT T1.AirportCode FROM AIRPORTS AS T1 JOIN FLIGHTS AS T2 ON T1.AirportCode  =  T2.DestAirport OR T1.AirportCode  =  T2.SourceAirport GROUP BY T1.AirportCode ORDER BY count(*) LIMIT 1	flight_2	What is the code of airport that has fewest number of flights?
SELECT T1.Airline FROM AIRLINES AS T1 JOIN FLIGHTS AS T2 ON T1.uid  =  T2.Airline GROUP BY T1.Airline ORDER BY count(*) DESC LIMIT 1	flight_2	Which airline has most number of flights?
SELECT T1.Abbreviation ,  T1.Country FROM AIRLINES AS T1 JOIN FLIGHTS AS T2 ON T1.uid  =  T2.Airline GROUP BY T1.Abbreviation ,  T1.Country ORDER BY count(*) LIMIT 1	flight_2	Find the abbreviation and country of the airline that has fewest number of flights?
SELECT T1.Airline FROM AIRLINES AS T1 JOIN FLIGHTS AS T2 ON T1.uid  =  T2.Airline WHERE T2.SourceAirport  =  'AHD'	flight_2	What are airlines that have some flight departing from airport 'AHD'?
SELECT T1.Airline FROM AIRLINES AS T1 JOIN FLIGHTS AS T2 ON T1.uid  =  T2.Airline WHERE T2.DestAirport  =  'AHD'	flight_2	What are airlines that have flights arriving at airport 'AHD'?
SELECT T1.Airline FROM AIRLINES AS T1 JOIN FLIGHTS AS T2 ON T1.uid  =  T2.Airline WHERE T2.SourceAirport  =  'APG' INTERSECT SELECT T1.Airline FROM AIRLINES AS T1 JOIN FLIGHTS AS T2 ON T1.uid  =  T2.Airline WHERE T2.SourceAirport  =  'CVO'	flight_2	Find all airlines that have flights from both airports 'APG' and 'CVO'.
SELECT T1.Airline FROM AIRLINES AS T1 JOIN FLIGHTS AS T2 ON T1.uid  =  T2.Airline WHERE T2.SourceAirport  =  'CVO' EXCEPT SELECT T1.Airline FROM AIRLINES AS T1 JOIN FLIGHTS AS T2 ON T1.uid  =  T2.Airline WHERE T2.SourceAirport  =  'APG'	flight_2	Find all airlines that have flights from airport 'CVO' but not from 'APG'.
SELECT T1.Airline FROM AIRLINES AS T1 JOIN FLIGHTS AS T2 ON T1.uid  =  T2.Airline GROUP BY T1.Airline HAVING count(*)  >  10	flight_2	Find all airlines that have at least 10 flights.
SELECT T1.Airline FROM AIRLINES AS T1 JOIN FLIGHTS AS T2 ON T1.uid  =  T2.Airline GROUP BY T1.Airline HAVING count(*)  <  200	flight_2	Find all airlines that have fewer than 200 flights.
SELECT T1.FlightNo FROM FLIGHTS AS T1 JOIN AIRLINES AS T2 ON T2.uid  =  T1.Airline WHERE T2.Airline  =  'United Airlines'	flight_2	What are flight numbers of Airline 'United Airlines'?
SELECT FlightNo FROM FLIGHTS WHERE SourceAirport  =  'APG'	flight_2	What are flight numbers of flights departing from Airport 'APG'?
SELECT FlightNo FROM FLIGHTS WHERE DestAirport  =  'APG'	flight_2	What are flight numbers of flights arriving at Airport 'APG'?
SELECT T1.FlightNo FROM FLIGHTS AS T1 JOIN AIRPORTS AS T2 ON T1.SourceAirport   =  T2.AirportCode WHERE T2.City  =  'Aberdeen'	flight_2	What are flight numbers of flights departing from City 'Aberdeen '?
SELECT T1.FlightNo FROM FLIGHTS AS T1 JOIN AIRPORTS AS T2 ON T1.DestAirport   =  T2.AirportCode WHERE T2.City  =  'Aberdeen'	flight_2	What are flight numbers of flights arriving at City 'Aberdeen'?
SELECT count(*) FROM Flights AS T1 JOIN Airports AS T2 ON T1.DestAirport  =  T2.AirportCode WHERE T2.city  =  'Aberdeen' OR T2.city  =  'Abilene'	flight_2	Find the number of flights landing in the city of Aberdeen or Abilene.
SELECT AirportName FROM Airports WHERE AirportCode NOT IN (SELECT SourceAirport FROM Flights UNION SELECT DestAirport FROM Flights)	flight_2	Find the name of airports which do not have any flight in and out.
SELECT count(*) FROM employee	employee_hire_evaluation	How many employees are there?
SELECT name FROM employee ORDER BY age	employee_hire_evaluation	Sort employee names by their age in ascending order.
SELECT count(*) ,  city FROM employee GROUP BY city	employee_hire_evaluation	What is the number of employees from each city?
SELECT city FROM employee WHERE age  <  30 GROUP BY city HAVING count(*)  >  1	employee_hire_evaluation	Which cities do more than one employee under age 30 come from?
SELECT count(*) ,  LOCATION FROM shop GROUP BY LOCATION	employee_hire_evaluation	Find the number of shops in each location.
SELECT manager_name ,  district FROM shop ORDER BY number_products DESC LIMIT 1	employee_hire_evaluation	Find the manager name and district of the shop whose number of products is the largest.
SELECT min(Number_products) ,  max(Number_products) FROM shop	employee_hire_evaluation	find the minimum and maximum number of products of all stores.
SELECT name ,  LOCATION ,  district FROM shop ORDER BY number_products DESC	employee_hire_evaluation	Return the name, location and district of all shops in descending order of number of products.
SELECT name FROM shop WHERE number_products  >  (SELECT avg(number_products) FROM shop)	employee_hire_evaluation	Find the names of stores whose number products is more than the average number of products.
SELECT t1.name FROM employee AS t1 JOIN evaluation AS t2 ON t1.Employee_ID  =  t2.Employee_ID GROUP BY t1.name ORDER BY count(*) DESC LIMIT 1	employee_hire_evaluation	find the name of employee who was awarded the most times in the evaluation.
SELECT t1.name FROM employee AS t1 JOIN evaluation AS t2 ON t1.Employee_ID  =  t2.Employee_ID ORDER BY t2.bonus DESC LIMIT 1	employee_hire_evaluation	Find the name of the employee who got the highest one time bonus.
SELECT name FROM employee WHERE Employee_ID NOT IN (SELECT Employee_ID FROM evaluation)	employee_hire_evaluation	Find the names of employees who never won any award in the evaluation.
SELECT t2.name FROM hiring AS t1 JOIN shop AS t2 ON t1.shop_id  =  t2.shop_id GROUP BY t2.name ORDER BY count(*) DESC LIMIT 1	employee_hire_evaluation	What is the name of the shop that is hiring the largest number of employees?
SELECT name FROM shop WHERE shop_id NOT IN (SELECT shop_id FROM hiring)	employee_hire_evaluation	Find the name of the shops that do not hire any employee.
SELECT count(*) ,  t2.name FROM hiring AS t1 JOIN shop AS t2 ON t1.shop_id  =  t2.shop_id GROUP BY t2.name	employee_hire_evaluation	Find the number of employees hired in each shop; show the shop name as well.
SELECT sum(bonus) FROM evaluation	employee_hire_evaluation	What is total bonus given in all evaluations?
SELECT * FROM hiring	employee_hire_evaluation	Give me all the information about hiring.
SELECT district FROM shop WHERE Number_products  <  3000 INTERSECT SELECT district FROM shop WHERE Number_products  >  10000	employee_hire_evaluation	Which district has both stores with less than 3000 products and stores with more than 10000 products?
SELECT count(DISTINCT LOCATION) FROM shop	employee_hire_evaluation	How many different store locations are there?
SELECT count(*) FROM Documents	cre_doc_template_mgt	How many documents do we have?
SELECT document_id ,  document_name ,  document_description FROM Documents	cre_doc_template_mgt	List document IDs, document names, and document descriptions for all documents.
SELECT document_name ,  template_id FROM Documents WHERE Document_Description LIKE '%w%'	cre_doc_template_mgt	What is the document name and template id for document with description with the letter 'w' in it?
SELECT document_id ,  template_id ,  Document_Description FROM Documents WHERE document_name  =  'Robbin CV'	cre_doc_template_mgt	What is the document id, template id and description for document named 'Robbin CV'?
SELECT count(DISTINCT template_id) FROM Documents	cre_doc_template_mgt	How many different templates do all document use?
SELECT count(*) FROM Documents AS T1 JOIN Templates AS T2 ON T1.Template_ID  =  T2.Template_ID WHERE T2.Template_Type_Code  =  'PPT'	cre_doc_template_mgt	How many documents are using the template with type code 'PPT'?
SELECT template_id ,  count(*) FROM Documents GROUP BY template_id	cre_doc_template_mgt	Show all template ids and number of documents using each template.
SELECT T1.template_id ,  T2.Template_Type_Code FROM Documents AS T1 JOIN Templates AS T2 ON T1.template_id  =  T2.template_id GROUP BY T1.template_id ,  T2.Template_Type_Code ORDER BY count(*) DESC LIMIT 1	cre_doc_template_mgt	What is the id and type code for the template used by the most documents?
SELECT template_id FROM Documents GROUP BY template_id HAVING count(*)  >  1	cre_doc_template_mgt	Show ids for all templates that are used by more than one document.
SELECT template_id FROM Templates EXCEPT SELECT template_id FROM Documents	cre_doc_template_mgt	Show ids for all templates not used by any document.
SELECT count(*) FROM Templates	cre_doc_template_mgt	How many templates do we have?
SELECT template_id ,  version_number ,  template_type_code FROM Templates	cre_doc_template_mgt	Show template ids, version numbers, and template type codes for all templates.
SELECT DISTINCT template_type_code FROM Templates	cre_doc_template_mgt	Show all distinct template type codes for all templates.
SELECT template_id FROM Templates WHERE template_type_code  =  'PP' OR template_type_code  =  'PPT'	cre_doc_template_mgt	What are the ids of templates with template type code PP or PPT?
SELECT count(*) FROM Templates WHERE template_type_code  =  'CV'	cre_doc_template_mgt	How many templates have template type code CV?
SELECT version_number ,  template_type_code FROM Templates WHERE version_number  >  5	cre_doc_template_mgt	What is the version number and template type code for the template with version number later than 5?
SELECT template_type_code ,  count(*) FROM Templates GROUP BY template_type_code	cre_doc_template_mgt	Show all template type codes and number of templates for each.
SELECT template_type_code FROM Templates GROUP BY template_type_code ORDER BY count(*) DESC LIMIT 1	cre_doc_template_mgt	Which template type code has most number of templates?
SELECT template_type_code FROM Templates GROUP BY template_type_code HAVING count(*)  <  3	cre_doc_template_mgt	Show all template type codes with less than three templates.
SELECT min(Version_Number) ,  template_type_code FROM Templates GROUP BY template_type_code	cre_doc_template_mgt	What the smallest version number and its template type code?
SELECT T1.template_type_code FROM Templates AS T1 JOIN Documents AS T2 ON T1.template_id  =  T2.template_id WHERE T2.document_name  =  'Data base'	cre_doc_template_mgt	What is the template type code of the template used by document with the name 'Data base'?
SELECT T2.document_name FROM Templates AS T1 JOIN Documents AS T2 ON T1.template_id  =  T2.template_id WHERE T1.template_type_code  =  'BK'	cre_doc_template_mgt	Show all document names using templates with template type code BK.
SELECT T1.template_type_code ,  count(*) FROM Templates AS T1 JOIN Documents AS T2 ON T1.template_id  =  T2.template_id GROUP BY T1.template_type_code	cre_doc_template_mgt	Show all template type codes and the number of documents using each type.
SELECT T1.template_type_code FROM Templates AS T1 JOIN Documents AS T2 ON T1.template_id  =  T2.template_id GROUP BY T1.template_type_code ORDER BY count(*) DESC LIMIT 1	cre_doc_template_mgt	Which template type code is used by most number of documents?
SELECT template_type_code FROM Templates EXCEPT SELECT template_type_code FROM Templates AS T1 JOIN Documents AS T2 ON T1.template_id  =  T2.template_id	cre_doc_template_mgt	Show all template type codes that are not used by any document.
SELECT template_type_code ,  template_type_description FROM Reference_template_types	cre_doc_template_mgt	Show all template type codes and descriptions.
SELECT template_type_description FROM Reference_template_types WHERE template_type_code  =  'AD'	cre_doc_template_mgt	What is the template type descriptions for template type code 'AD'.
SELECT template_type_code FROM Reference_template_types WHERE template_type_description  =  'Book'	cre_doc_template_mgt	What is the template type code for template type description 'Book'.
SELECT DISTINCT T1.template_type_description FROM Reference_template_types AS T1 JOIN Templates AS T2 ON T1.template_type_code  = T2.template_type_code JOIN Documents AS T3 ON T2.Template_ID  =  T3.template_ID	cre_doc_template_mgt	What are the distinct template type descriptions for the templates ever used by any document?
SELECT T2.template_id FROM Reference_template_types AS T1 JOIN Templates AS T2 ON T1.template_type_code  = T2.template_type_code WHERE T1.template_type_description  =  'Presentation'	cre_doc_template_mgt	What are the template ids with template type description 'Presentation'.
SELECT count(*) FROM Paragraphs	cre_doc_template_mgt	How many paragraphs in total?
SELECT count(*) FROM Paragraphs AS T1 JOIN Documents AS T2 ON T1.document_ID  =  T2.document_ID WHERE T2.document_name  =  'Summer Show'	cre_doc_template_mgt	How many paragraphs for the document with name 'Summer Show'?
SELECT Other_Details FROM Paragraphs WHERE paragraph_text  =  'Korea'	cre_doc_template_mgt	Show paragraph details for paragraph with text 'Korea'.
SELECT T1.paragraph_id ,   T1.paragraph_text FROM Paragraphs AS T1 JOIN Documents AS T2 ON T1.document_id  =  T2.document_id WHERE T2.Document_Name  =  'Welcome to NY'	cre_doc_template_mgt	Show all paragraph ids and texts for the document with name 'Welcome to NY'.
SELECT T1.paragraph_text FROM Paragraphs AS T1 JOIN Documents AS T2 ON T1.document_id  =  T2.document_id WHERE T2.document_name  =  'Customer reviews'	cre_doc_template_mgt	Show all paragraph texts for the document 'Customer reviews'.
SELECT document_id ,  count(*) FROM Paragraphs GROUP BY document_id ORDER BY document_id	cre_doc_template_mgt	Show all document ids and the number of paragraphs in each document. Order by document id.
SELECT T1.document_id ,  T2.document_name ,  count(*) FROM Paragraphs AS T1 JOIN Documents AS T2 ON T1.document_id  =  T2.document_id GROUP BY T1.document_id,  T2.document_name	cre_doc_template_mgt	Show all document ids, names and the number of paragraphs in each document.
SELECT document_id FROM Paragraphs GROUP BY document_id HAVING count(*)  >=  2	cre_doc_template_mgt	List all document ids with at least two paragraphs.
SELECT T1.document_id ,  T2.document_name FROM Paragraphs AS T1 JOIN Documents AS T2 ON T1.document_id  =  T2.document_id GROUP BY T1.document_id, T2.document_name ORDER BY count(*) DESC LIMIT 1	cre_doc_template_mgt	What is the document id and name with greatest number of paragraphs?
SELECT document_id FROM Paragraphs GROUP BY document_id ORDER BY count(*) ASC LIMIT 1	cre_doc_template_mgt	What is the document id with least number of paragraphs?
SELECT document_id FROM Paragraphs GROUP BY document_id HAVING count(*) BETWEEN 1 AND 2	cre_doc_template_mgt	What is the document id with 1 to 2 paragraphs?
SELECT document_id FROM Paragraphs WHERE paragraph_text  =  'Brazil' INTERSECT SELECT document_id FROM Paragraphs WHERE paragraph_text  =  'Ireland'	cre_doc_template_mgt	Show the document id with paragraph text 'Brazil' and 'Ireland'.
SELECT count(*) FROM teacher	course_teach	How many teachers are there?
SELECT Name FROM teacher ORDER BY Age ASC	course_teach	List the names of teachers in ascending order of age.
SELECT Age ,  Hometown FROM teacher	course_teach	What are the age and hometown of teachers?
SELECT Name FROM teacher WHERE Hometown != 'Little Lever Urban District'	course_teach	List the name of teachers whose hometown is not 'Little Lever Urban District'.
SELECT Name FROM teacher WHERE Age  =  32 OR Age  =  33	course_teach	Show the name of teachers aged either 32 or 33?
SELECT Hometown FROM teacher ORDER BY Age ASC LIMIT 1	course_teach	What is the hometown of the youngest teacher?
SELECT Hometown ,  COUNT(*) FROM teacher GROUP BY Hometown	course_teach	Show different hometown of teachers and the number of teachers from each hometown.
SELECT Hometown FROM teacher GROUP BY Hometown ORDER BY COUNT(*) DESC LIMIT 1	course_teach	List the most common hometown of teachers.
SELECT Hometown FROM teacher GROUP BY Hometown HAVING COUNT(*)  >=  2	course_teach	Show the hometowns shared by at least two teachers.
SELECT T3.Name ,  T2.Course FROM course_arrange AS T1 JOIN course AS T2 ON T1.Course_ID  =  T2.Course_ID JOIN teacher AS T3 ON T1.Teacher_ID  =  T3.Teacher_ID	course_teach	Show names of teachers and the courses they are arranged to teach.
SELECT T3.Name ,  T2.Course FROM course_arrange AS T1 JOIN course AS T2 ON T1.Course_ID  =  T2.Course_ID JOIN teacher AS T3 ON T1.Teacher_ID  =  T3.Teacher_ID ORDER BY T3.Name	course_teach	Show names of teachers and the courses they are arranged to teach in ascending alphabetical order of the teacher's name.
SELECT T3.Name FROM course_arrange AS T1 JOIN course AS T2 ON T1.Course_ID  =  T2.Course_ID JOIN teacher AS T3 ON T1.Teacher_ID  =  T3.Teacher_ID WHERE T2.Course  =  'Math'	course_teach	Show the name of the teacher for the math course.
SELECT T2.Name ,  COUNT(*) FROM course_arrange AS T1 JOIN teacher AS T2 ON T1.Teacher_ID  =  T2.Teacher_ID GROUP BY T2.Name	course_teach	Show names of teachers and the number of courses they teach.
SELECT T2.Name FROM course_arrange AS T1 JOIN teacher AS T2 ON T1.Teacher_ID  =  T2.Teacher_ID GROUP BY T2.Name HAVING COUNT(*)  >=  2	course_teach	Show names of teachers that teach at least two courses.
SELECT Name FROM teacher WHERE Teacher_id NOT IN (SELECT Teacher_id FROM course_arrange)	course_teach	List the names of teachers who have not been arranged to teach courses.
SELECT count(*) FROM visitor WHERE age  <  30	museum_visit	How many visitors below age 30 are there?
SELECT name FROM visitor WHERE Level_of_membership  >  4 ORDER BY Level_of_membership DESC	museum_visit	Find the names of the visitors whose membership level is higher than 4, and order the results by the level from high to low.
SELECT avg(age) FROM visitor WHERE Level_of_membership  <=  4	museum_visit	What is the average age of the visitors whose membership level is not higher than 4?
SELECT name ,  Level_of_membership FROM visitor WHERE Level_of_membership  >  4 ORDER BY age DESC	museum_visit	Find the name and membership level of the visitors whose membership level is higher than 4, and sort by their age from old to young.
SELECT museum_id ,  name FROM museum ORDER BY num_of_staff DESC LIMIT 1	museum_visit	Find the id and name of the museum that has the most staff members?
SELECT avg(num_of_staff) FROM museum WHERE open_year  <  2009	museum_visit	Find the average number of staff working for the museums that were open before 2009.
SELECT Num_of_Staff ,  Open_Year FROM museum WHERE name  =  'Plaza Museum'	museum_visit	What are the opening year and staff number of the museum named Plaza Museum?
SELECT name FROM museum WHERE num_of_staff  >  (SELECT min(num_of_staff) FROM museum WHERE open_year  >  2010)	museum_visit	find the names of museums which have more staff than the minimum staff number of all museums opened after 2010.
SELECT t1.id ,  t1.name ,  t1.age FROM visitor AS t1 JOIN visit AS t2 ON t1.id  =  t2.visitor_id GROUP BY t1.id HAVING count(*)  >  1	museum_visit	find the id, name and age for visitors who visited some museums more than once.
SELECT t2.visitor_id ,  t1.name ,  t1.Level_of_membership FROM visitor AS t1 JOIN visit AS t2 ON t1.id  =  t2.visitor_id GROUP BY t2.visitor_id,  t1.name,  t1.Level_of_membership ORDER BY sum(t2.Total_spent) DESC LIMIT 1	museum_visit	What are the id, name and membership level of visitors who have spent the largest amount of money in total in all museum tickets?
SELECT t2.Museum_ID ,  t1.name FROM museum AS t1 JOIN visit AS t2 ON t1.Museum_ID  =  t2.Museum_ID GROUP BY t2.Museum_ID ,  t1.name ORDER BY count(*) DESC LIMIT 1	museum_visit	What are the id and name of the museum visited most times?
SELECT name FROM museum WHERE Museum_ID NOT IN (SELECT museum_id FROM visit)	museum_visit	What is the name of the museum that had no visitor yet?
SELECT t1.name ,  t1.age FROM visitor AS t1 JOIN visit AS t2 ON t1.id  =  t2.visitor_id ORDER BY t2.num_of_ticket DESC LIMIT 1	museum_visit	Find the name and age of the visitor who bought the most tickets at once.
SELECT avg(num_of_ticket) ,  max(num_of_ticket) FROM visit	museum_visit	What are the average and maximum number of tickets bought in all visits?
SELECT sum(t2.Total_spent) FROM visitor AS t1 JOIN visit AS t2 ON t1.id  =  t2.visitor_id WHERE t1.Level_of_membership  =  1	museum_visit	What is the total ticket expense of the visitors whose membership level is 1?
SELECT t1.name FROM visitor AS t1 JOIN visit AS t2 ON t1.id  =  t2.visitor_id JOIN museum AS t3 ON t3.Museum_ID  =  t2.Museum_ID WHERE t3.open_year  <  2009 INTERSECT SELECT t1.name FROM visitor AS t1 JOIN visit AS t2 ON t1.id  =  t2.visitor_id JOIN museum AS t3 ON t3.Museum_ID  =  t2.Museum_ID WHERE t3.open_year  >  2011	museum_visit	What is the name of the visitor who visited both a museum opened before 2009 and a museum opened after 2011?
SELECT count(*) FROM visitor WHERE id NOT IN (SELECT t2.visitor_id FROM museum AS t1 JOIN visit AS t2 ON t1.Museum_ID  =  t2.Museum_ID WHERE t1.open_year  >  2010)	museum_visit	Find the number of visitors who did not visit any museum opened after 2010.
SELECT count(*) FROM museum WHERE open_year  >  2013 OR open_year  <  2008	museum_visit	How many museums were opened after 2013 or before 2008?
SELECT count(*) FROM players	wta_1	Find the total number of players.
SELECT count(*) FROM matches	wta_1	Find the total number of matches.
SELECT avg(loser_age) ,  avg(winner_age) FROM matches	wta_1	Find the average age of losers and winners of all matches.
SELECT avg(winner_rank) FROM matches	wta_1	Find the average rank of winners in all matches.
SELECT min(loser_rank) FROM matches	wta_1	Find the highest rank of losers in all matches.
SELECT count(DISTINCT country_code) FROM players	wta_1	find the number of distinct country codes of all players.
SELECT count(DISTINCT loser_name) FROM matches	wta_1	Find the number of distinct name of losers.
SELECT tourney_name FROM matches GROUP BY tourney_name HAVING count(*)  >  10	wta_1	Find the name of tourney that has more than 10 matches.
SELECT winner_name FROM matches WHERE YEAR  =  2013 INTERSECT SELECT winner_name FROM matches WHERE YEAR  =  2016	wta_1	List the names of all winners who played in both 2013 and 2016.
SELECT count(*) FROM matches WHERE YEAR  =  2013 OR YEAR  =  2016	wta_1	List the number of all matches who played in years of 2013 or 2016.
SELECT T1.country_code ,  T1.first_name FROM players AS T1 JOIN matches AS T2 ON T1.player_id  =  T2.winner_id WHERE T2.tourney_name  =  'WTA Championships' INTERSECT SELECT T1.country_code ,  T1.first_name FROM players AS T1 JOIN matches AS T2 ON T1.player_id  =  T2.winner_id WHERE T2.tourney_name  =  'Australian Open'	wta_1	What are the country code and first name of the players who won in both tourney WTA Championships and Australian Open?
SELECT first_name ,  country_code FROM players ORDER BY birth_date LIMIT 1	wta_1	Find the first name and country code of the oldest player.
SELECT first_name ,  last_name FROM players WHERE hand  =  'L' ORDER BY birth_date	wta_1	List the first and last name of all players who are left / L hand in the order of birth date.
SELECT T1.country_code ,  T1.first_name FROM players AS T1 JOIN rankings AS T2 ON T1.player_id  =  T2.player_id ORDER BY T2.tours DESC LIMIT 1	wta_1	Find the first name and country code of the player who did the most number of tours.
SELECT YEAR FROM matches GROUP BY YEAR ORDER BY count(*) DESC LIMIT 1	wta_1	Find the year that has the most number of matches.
SELECT winner_name ,  winner_rank_points FROM matches GROUP BY winner_name, winner_rank_points ORDER BY count(*) DESC LIMIT 1	wta_1	Find the name and rank points of the winner who won the most times.
SELECT winner_name FROM matches WHERE tourney_name  =  'Australian Open' ORDER BY winner_rank_points DESC LIMIT 1	wta_1	Find the name of the winner who has the highest rank points and participated in the Australian Open tourney.
SELECT winner_name ,  loser_name FROM matches ORDER BY minutes DESC LIMIT 1	wta_1	find the names of loser and winner who played in the match with greatest number of minutes.
SELECT sum(ranking_points) ,  T1.first_name FROM players AS T1 JOIN rankings AS T2 ON T1.player_id  =  T2.player_id GROUP BY T1.first_name	wta_1	Find the total ranking points for each player and their first name.
SELECT count(*) ,  country_code FROM players GROUP BY country_code	wta_1	find the number of players for each country.
SELECT country_code FROM players GROUP BY country_code ORDER BY count(*) DESC LIMIT 1	wta_1	find the code of the country where has the greatest number of players.
SELECT country_code FROM players GROUP BY country_code HAVING count(*)  >  50	wta_1	Find the codes of countries that have more than 50 players.
SELECT sum(tours) ,  ranking_date FROM rankings GROUP BY ranking_date	wta_1	Find the total number of tours for each ranking date.
SELECT count(*) ,  YEAR FROM matches GROUP BY YEAR	wta_1	Find the number of matches happened in each year.
SELECT DISTINCT winner_name ,  winner_rank, winner_age FROM matches ORDER BY winner_age LIMIT 3	wta_1	Find the name and rank of the 3 youngest winners across all matches.
SELECT count(DISTINCT winner_name) FROM matches WHERE tourney_name  =  'WTA Championships' AND winner_hand  =  'L'	wta_1	How many different winners both participated in the WTA Championships and were left handed?
SELECT T1.first_name ,  T1.country_code ,  T1.birth_date FROM players AS T1 JOIN matches AS T2 ON T1.player_id  =  T2.winner_id ORDER BY T2.winner_rank_points DESC LIMIT 1	wta_1	Find the first name, country code and birth date of the winner who has the highest rank points in all matches.
SELECT count(*) ,  hand FROM players GROUP BY hand	wta_1	Find the number of players for each hand type.
SELECT count(*) FROM ship WHERE disposition_of_ship  =  'Captured'	battle_death	How many ships ended up being 'Captured'?
SELECT name ,  tonnage FROM ship ORDER BY name DESC	battle_death	List the name and tonnage ordered by in descending alphaetical order for the names.
SELECT name ,  date FROM battle	battle_death	List the name, date and result of each battle.
SELECT max(killed) ,  min(killed) FROM death	battle_death	What is maximum and minimum death toll caused each time?
SELECT avg(injured) FROM death	battle_death	What is the average number of injuries caused each time?
SELECT T1.killed ,  T1.injured FROM death AS T1 JOIN ship AS t2 ON T1.caused_by_ship_id  =  T2.id WHERE T2.tonnage  =  't'	battle_death	What are the death and injury situations caused by the ship with tonnage 't'?
SELECT name ,  RESULT FROM battle WHERE bulgarian_commander != 'Boril'	battle_death	What are the name and results of the battles when the bulgarian commander is not 'Boril'
SELECT DISTINCT T1.id ,  T1.name FROM battle AS T1 JOIN ship AS T2 ON T1.id  =  T2.lost_in_battle WHERE T2.ship_type  =  'Brig'	battle_death	What are the different ids and names of the battles that lost any 'Brig' type shipes?
SELECT T1.id ,  T1.name FROM battle AS T1 JOIN ship AS T2 ON T1.id  =  T2.lost_in_battle JOIN death AS T3 ON T2.id  =  T3.caused_by_ship_id GROUP BY T1.id HAVING sum(T3.killed)  >  10	battle_death	What are the ids and names of the battles that led to more than 10 people killed in total.
SELECT T2.id ,  T2.name FROM death AS T1 JOIN ship AS t2 ON T1.caused_by_ship_id  =  T2.id GROUP BY T2.id ORDER BY count(*) DESC LIMIT 1	battle_death	What is the ship id and name that caused most total injuries?
SELECT name FROM battle WHERE bulgarian_commander  =  'Kaloyan' AND latin_commander  =  'Baldwin I'	battle_death	What are the distinct battle names which are between bulgarian commander 'Kaloyan' and latin commander 'Baldwin I'?
SELECT count(DISTINCT RESULT) FROM battle	battle_death	How many different results are there for the battles?
SELECT count(*) FROM battle WHERE id NOT IN ( SELECT lost_in_battle FROM ship WHERE tonnage  =  '225' );	battle_death	How many battles did not lose any ship with tonnage '225'?
SELECT T1.name ,  T1.date FROM battle AS T1 JOIN ship AS T2 ON T1.id  =  T2.lost_in_battle WHERE T2.name  =  'Lettice' INTERSECT SELECT T1.name ,  T1.date FROM battle AS T1 JOIN ship AS T2 ON T1.id  =  T2.lost_in_battle WHERE T2.name  =  'HMS Atalanta'	battle_death	List the name and date the battle that has lost the ship named 'Lettice' and the ship named 'HMS Atalanta'
SELECT name ,  RESULT ,  bulgarian_commander FROM battle EXCEPT SELECT T1.name ,  T1.result ,  T1.bulgarian_commander FROM battle AS T1 JOIN ship AS T2 ON T1.id  =  T2.lost_in_battle WHERE T2.location  =  'English Channel'	battle_death	Show names, results and bulgarian commanders of the battles with no ships lost in the 'English Channel'.
SELECT note FROM death WHERE note LIKE '%East%'	battle_death	What are the notes of the death events which has substring 'East'?
SELECT line_1 ,  line_2 FROM addresses	student_transcripts_tracking	what are all the addresses including line 1 and line 2?
SELECT count(*) FROM Courses	student_transcripts_tracking	How many courses in total are listed?
SELECT course_description FROM Courses WHERE course_name  =  'math'	student_transcripts_tracking	How is the math course described?
SELECT zip_postcode FROM Addresses WHERE city  =  'Port Chelsea'	student_transcripts_tracking	What is the zip code of the address in the city Port Chelsea?
SELECT T2.department_name ,  T1.department_id FROM Degree_Programs AS T1 JOIN Departments AS T2 ON T1.department_id  =  T2.department_id GROUP BY T2.department_name ,  T1.department_id ORDER BY count(*) DESC LIMIT 1	student_transcripts_tracking	Which department offers the most number of degrees? List department name and id.
SELECT count(DISTINCT department_id) FROM Degree_Programs	student_transcripts_tracking	How many departments offer any degree?
SELECT count(DISTINCT degree_summary_name) FROM Degree_Programs	student_transcripts_tracking	How many different degree names are offered?
SELECT count(*) FROM Departments AS T1 JOIN Degree_Programs AS T2 ON T1.department_id  =  T2.department_id WHERE T1.department_name  =  'engineer'	student_transcripts_tracking	How many degrees does the engineering department offer?
SELECT section_name ,  section_description FROM Sections	student_transcripts_tracking	What are the names and descriptions of all the sections?
SELECT T1.course_name ,  T1.course_id FROM Courses AS T1 JOIN Sections AS T2 ON T1.course_id  =  T2.course_id GROUP BY T1.course_id HAVING count(*)  <=  2	student_transcripts_tracking	What are the names and id of courses having at most 2 sections?
SELECT section_name FROM Sections ORDER BY section_name DESC	student_transcripts_tracking	List the section_name in reversed lexicographical order.
SELECT T1.semester_name ,  T1.semester_id FROM Semesters AS T1 JOIN Student_Enrolment AS T2 ON T1.semester_id  =  T2.semester_id GROUP BY T1.semester_id ORDER BY count(*) DESC LIMIT 1	student_transcripts_tracking	What is the semester which most student registered in? Show both the name and the id.
SELECT department_description FROM Departments WHERE department_name LIKE '%computer%'	student_transcripts_tracking	What is the description of the department whose name has the substring the computer?
SELECT T1.first_name ,  T1.middle_name ,  T1.last_name ,  T1.student_id FROM Students AS T1 JOIN Student_Enrolment AS T2 ON T1.student_id  =  T2.student_id GROUP BY T1.student_id HAVING count(*)  =  2	student_transcripts_tracking	Who are enrolled in 2 degree programs in one semester? List the first name, middle name and last name and the id.
SELECT DISTINCT T1.first_name ,  T1.middle_name ,  T1.last_name FROM Students AS T1 JOIN Student_Enrolment AS T2 ON T1.student_id  =  T2.student_id JOIN Degree_Programs AS T3 ON T2.degree_program_id  =  T3.degree_program_id WHERE T3.degree_summary_name  =  'Bachelor'	student_transcripts_tracking	Who is enrolled in a Bachelor degree program? List the first name, middle name, last name.
SELECT T1.degree_summary_name FROM Degree_Programs AS T1 JOIN Student_Enrolment AS T2 ON T1.degree_program_id  =  T2.degree_program_id GROUP BY T1.degree_summary_name ORDER BY count(*) DESC LIMIT 1	student_transcripts_tracking	Find the kind of program which most number of students are enrolled in?
SELECT T1.degree_program_id ,  T1.degree_summary_name FROM Degree_Programs AS T1 JOIN Student_Enrolment AS T2 ON T1.degree_program_id  =  T2.degree_program_id GROUP BY T1.degree_program_id ORDER BY count(*) DESC LIMIT 1	student_transcripts_tracking	Find the program which most number of students are enrolled in. List both the id and the summary.
SELECT semester_name FROM Semesters WHERE semester_id NOT IN( SELECT semester_id FROM Student_Enrolment )	student_transcripts_tracking	Which semesters do not have any student enrolled? List the semester name.
SELECT DISTINCT T1.course_name FROM Courses AS T1 JOIN Student_Enrolment_Courses AS T2 ON T1.course_id  =  T2.course_id	student_transcripts_tracking	What are all the course names of the courses which ever have students enrolled in?
SELECT  T1.course_name FROM Courses AS T1 JOIN Student_Enrolment_Courses AS T2 ON T1.course_id  =  T2.course_id GROUP BY T1.course_name ORDER BY count(*) DESC LIMIT 1	student_transcripts_tracking	What's the name of the course with most number of enrollments?
SELECT T1.last_name FROM Students AS T1 JOIN Addresses AS T2 ON T1.current_address_id  =  T2.address_id WHERE T2.state_province_county  =  'NorthCarolina' EXCEPT SELECT DISTINCT T3.last_name FROM Students AS T3 JOIN Student_Enrolment AS T4 ON T3.student_id  =  T4.student_id	student_transcripts_tracking	Find the last name of the students who currently live in the state of North Carolina but have not registered in any degree program.
SELECT T2.transcript_date ,  T1.transcript_id FROM Transcript_Contents AS T1 JOIN Transcripts AS T2 ON T1.transcript_id  =  T2.transcript_id GROUP BY T2.transcript_date, T1.transcript_id HAVING count(*)  >=  2	student_transcripts_tracking	Show the date and id of the transcript with at least 2 course results.
SELECT cell_mobile_number FROM Students WHERE first_name  =  'Timmothy' AND last_name  =  'Ward'	student_transcripts_tracking	What is the phone number of the man with the first name Timmothy and the last name Ward?
SELECT first_name ,  middle_name ,  last_name FROM Students ORDER BY date_first_registered ASC LIMIT 1	student_transcripts_tracking	Who is the first student to register? List the first name, middle name and last name.
SELECT first_name ,  middle_name ,  last_name FROM Students ORDER BY date_left ASC LIMIT 1	student_transcripts_tracking	Who is the earliest graduate of the school? List the first name, middle name and last name.
SELECT first_name FROM Students WHERE current_address_id != permanent_address_id	student_transcripts_tracking	Whose permanent address is different from his or her current address? List his or her first name.
SELECT T1.address_id ,  T1.line_1 ,  T1.line_2 FROM Addresses AS T1 JOIN Students AS T2 ON T1.address_id  =  T2.current_address_id GROUP BY T1.address_id,  T1.line_1 ,  T1.line_2 ORDER BY count(*) DESC LIMIT 1	student_transcripts_tracking	Which address holds the most number of students currently? List the address id and all lines.
SELECT avg(extract(year from transcript_date)) FROM Transcripts	student_transcripts_tracking	On average, when were the transcripts printed?
SELECT transcript_date ,  other_details FROM Transcripts ORDER BY transcript_date ASC LIMIT 1	student_transcripts_tracking	When is the first transcript released? List the date and details.
SELECT count(*) FROM Transcripts	student_transcripts_tracking	How many transcripts are released?
SELECT transcript_date FROM Transcripts ORDER BY transcript_date DESC LIMIT 1	student_transcripts_tracking	What is the last transcript release date?
SELECT count(*) ,  student_course_id FROM Transcript_Contents GROUP BY student_course_id ORDER BY count(*) DESC LIMIT 1	student_transcripts_tracking	How many times at most can a course enrollment result show in different transcripts? Also show the course enrollment id.
SELECT T2.transcript_date ,  T1.transcript_id FROM Transcript_Contents AS T1 JOIN Transcripts AS T2 ON T1.transcript_id  =  T2.transcript_id GROUP BY T2.transcript_date, T1.transcript_id ORDER BY count(*) ASC LIMIT 1	student_transcripts_tracking	Show the date of the transcript which shows the least number of results, also list the id.
SELECT DISTINCT T2.semester_id FROM Degree_Programs AS T1 JOIN Student_Enrolment AS T2 ON T1.degree_program_id  =  T2.degree_program_id WHERE degree_summary_name  =  'Master' INTERSECT SELECT DISTINCT T2.semester_id FROM Degree_Programs AS T1 JOIN Student_Enrolment AS T2 ON T1.degree_program_id  =  T2.degree_program_id WHERE degree_summary_name  =  'Bachelor'	student_transcripts_tracking	Find the semester when both Master students and Bachelor students got enrolled in.
SELECT count(DISTINCT current_address_id) FROM Students	student_transcripts_tracking	How many different addresses do the students currently live?
SELECT other_student_details FROM Students ORDER BY other_student_details DESC	student_transcripts_tracking	List all the student details in reversed lexicographical order.
SELECT section_description FROM Sections WHERE section_name  =  'h'	student_transcripts_tracking	Describe the section h.
SELECT T1.first_name FROM Students AS T1 JOIN Addresses AS T2 ON T1.permanent_address_id  =  T2.address_id WHERE T2.country  =  'Haiti' UNION SELECT first_name FROM Students WHERE cell_mobile_number  =  '09700166582'	student_transcripts_tracking	Find the first name of the students who permanently live in the country Haiti or have the cell phone number 09700166582.
SELECT Title FROM Cartoon ORDER BY title	tvshow	List the title of all cartoons in alphabetical order.
SELECT Title FROM Cartoon WHERE Directed_by = 'Ben Jones';	tvshow	List all cartoon directed by 'Ben Jones'.
SELECT count(*) FROM Cartoon WHERE Written_by = 'Joseph Kuhr';	tvshow	How many cartoons were written by 'Joseph Kuhr'?
SELECT title ,  Directed_by FROM Cartoon ORDER BY Original_air_date	tvshow	list all cartoon titles and their directors ordered by their air date
SELECT Title FROM Cartoon WHERE Directed_by = 'Ben Jones' OR Directed_by = 'Brandon Vietti';	tvshow	List the title of all cartoon directed by 'Ben Jones' or 'Brandon Vietti'.
SELECT Country ,  count(*) FROM TV_Channel GROUP BY Country ORDER BY count(*) DESC LIMIT 1;	tvshow	Which country has the most of TV Channels? List the country and number of TV Channels it has.
SELECT count(DISTINCT series_name) ,  count(DISTINCT content) FROM TV_Channel;	tvshow	List the number of different series names and contents in the TV Channel table.
SELECT Content FROM TV_Channel WHERE series_name = 'Sky Radio';	tvshow	What is the content of TV Channel with serial name 'Sky Radio'?
SELECT Package_Option FROM TV_Channel WHERE series_name = 'Sky Radio';	tvshow	What is the Package Option of TV Channel with serial name 'Sky Radio'?
SELECT count(*) FROM TV_Channel WHERE LANGUAGE = 'English';	tvshow	How many TV Channel using language English?
SELECT LANGUAGE ,  count(*) FROM TV_Channel GROUP BY LANGUAGE ORDER BY count(*) ASC LIMIT 1;	tvshow	List the language used least number of TV Channel. List language and number of TV Channel.
SELECT T1.series_name FROM TV_Channel AS T1 JOIN Cartoon AS T2 ON T1.id = T2.Channel WHERE T2.Title = 'The Rise of the Blue Beetle!';	tvshow	What is the TV Channel that shows the cartoon 'The Rise of the Blue Beetle!'? List the TV Channel's series name.
SELECT T2.Title FROM TV_Channel AS T1 JOIN Cartoon AS T2 ON T1.id = T2.Channel WHERE T1.series_name = 'Sky Radio';	tvshow	List the title of all  Cartoons showed on TV Channel with series name 'Sky Radio'.
SELECT Episode FROM TV_series ORDER BY rating	tvshow	List the Episode of all TV series sorted by rating.
SELECT Episode ,  Rating FROM TV_series ORDER BY Rating DESC LIMIT 3;	tvshow	List top 3 highest Rating  TV series. List the TV series's Episode and Rating.
SELECT max(SHARE) , min(SHARE) FROM TV_series;	tvshow	What is minimum and maximum share of TV series?
SELECT Air_Date FROM TV_series WHERE Episode = 'A Love of a Lifetime';	tvshow	What is the air date of TV series with Episode 'A Love of a Lifetime'?
SELECT Weekly_Rank FROM TV_series WHERE Episode = 'A Love of a Lifetime';	tvshow	What is Weekly Rank of TV series with Episode 'A Love of a Lifetime'?
SELECT T1.series_name FROM TV_Channel AS T1 JOIN TV_series AS T2 ON T1.id = T2.Channel WHERE T2.Episode = 'A Love of a Lifetime';	tvshow	What is the TV Channel of TV series with Episode 'A Love of a Lifetime'? List the TV Channel's series name.
SELECT T2.Episode FROM TV_Channel AS T1 JOIN TV_series AS T2 ON T1.id = T2.Channel WHERE T1.series_name = 'Sky Radio';	tvshow	List the Episode of all  TV series showed on TV Channel with series name 'Sky Radio'.
SELECT count(*) ,  Directed_by FROM cartoon GROUP BY Directed_by	tvshow	Find the number of cartoons directed by each of the listed directors.
SELECT production_code ,  channel FROM cartoon ORDER BY original_air_date LIMIT 1	tvshow	Find the production code and channel of the most recently aired cartoon.
SELECT package_option ,  series_name FROM TV_Channel WHERE high_definition_TV  =  'yes'	tvshow	Find the package choice and series name of the TV channel that has high definition TV.
SELECT T1.country FROM TV_Channel AS T1 JOIN cartoon AS T2 ON T1.id = T2.Channel WHERE T2.written_by  =  'Todd Casey'	tvshow	which countries' tv channels are playing some cartoon written by Todd Casey?
SELECT country FROM TV_Channel EXCEPT SELECT T1.country FROM TV_Channel AS T1 JOIN cartoon AS T2 ON T1.id = T2.Channel WHERE T2.written_by  =  'Todd Casey'	tvshow	which countries' tv channels are not playing any cartoon written by Todd Casey?
SELECT T1.series_name ,  T1.country FROM TV_Channel AS T1 JOIN cartoon AS T2 ON T1.id = T2.Channel WHERE T2.directed_by  =  'Michael Chang' INTERSECT SELECT T1.series_name ,  T1.country FROM TV_Channel AS T1 JOIN cartoon AS T2 ON T1.id = T2.Channel WHERE T2.directed_by  =  'Ben Jones'	tvshow	Find the series name and country of the tv channel that is playing some cartoons directed by Ben Jones and Michael Chang?
SELECT Pixel_aspect_ratio_PAR ,  country FROM tv_channel WHERE LANGUAGE != 'English'	tvshow	find the pixel aspect ratio and nation of the tv channels that do not use English.
SELECT id FROM tv_channel GROUP BY id HAVING count(*)  >  2	tvshow	find id of the tv channels that from the countries where have more than two tv channels.
SELECT id FROM TV_Channel EXCEPT SELECT channel FROM cartoon WHERE directed_by  =  'Ben Jones'	tvshow	find the id of tv channels that do not play any cartoon directed by Ben Jones.
SELECT package_option FROM TV_Channel WHERE id NOT IN (SELECT channel FROM cartoon WHERE directed_by  =  'Ben Jones')	tvshow	find the package option of the tv channel that do not have any cartoon directed by Ben Jones.
SELECT count(*) FROM poker_player	poker_player	How many poker players are there?
SELECT Earnings FROM poker_player ORDER BY Earnings DESC	poker_player	List the earnings of poker players in descending order.
SELECT Final_Table_Made ,  Best_Finish FROM poker_player	poker_player	List the final tables made and the best finishes of poker players.
SELECT avg(Earnings) FROM poker_player	poker_player	What is the average earnings of poker players?
SELECT Money_Rank FROM poker_player ORDER BY Earnings DESC LIMIT 1	poker_player	What is the money rank of the poker player with the highest earnings?
SELECT max(Final_Table_Made) FROM poker_player WHERE Earnings  <  200000	poker_player	What is the maximum number of final tables made among poker players with earnings less than 200000?
SELECT T1.Name FROM people AS T1 JOIN poker_player AS T2 ON T1.People_ID  =  T2.People_ID	poker_player	What are the names of poker players?
SELECT T1.Name FROM people AS T1 JOIN poker_player AS T2 ON T1.People_ID  =  T2.People_ID WHERE T2.Earnings  >  300000	poker_player	What are the names of poker players whose earnings is higher than 300000?
SELECT T1.Name FROM people AS T1 JOIN poker_player AS T2 ON T1.People_ID  =  T2.People_ID ORDER BY T2.Final_Table_Made	poker_player	List the names of poker players ordered by the final tables made in ascending order.
SELECT T1.Birth_Date FROM people AS T1 JOIN poker_player AS T2 ON T1.People_ID  =  T2.People_ID ORDER BY T2.Earnings ASC LIMIT 1	poker_player	What is the birth date of the poker player with the lowest earnings?
SELECT T2.Money_Rank FROM people AS T1 JOIN poker_player AS T2 ON T1.People_ID  =  T2.People_ID ORDER BY T1.Height DESC LIMIT 1	poker_player	What is the money rank of the tallest poker player?
SELECT avg(T2.Earnings) FROM people AS T1 JOIN poker_player AS T2 ON T1.People_ID  =  T2.People_ID WHERE T1.Height  >  200	poker_player	What is the average earnings of poker players with height higher than 200?
SELECT T1.Name FROM people AS T1 JOIN poker_player AS T2 ON T1.People_ID  =  T2.People_ID ORDER BY T2.Earnings DESC	poker_player	What are the names of poker players in descending order of earnings?
SELECT Nationality ,  COUNT(*) FROM people GROUP BY Nationality	poker_player	What are different nationalities of people and the corresponding number of people from each nation?
SELECT Nationality FROM people GROUP BY Nationality ORDER BY COUNT(*) DESC LIMIT 1	poker_player	What is the most common nationality of people?
SELECT Nationality FROM people GROUP BY Nationality HAVING COUNT(*)  >=  2	poker_player	What are the nationalities that are shared by at least two people?
SELECT Name ,  Birth_Date FROM people ORDER BY Name ASC	poker_player	List the names and birth dates of people in ascending alphabetical order of name.
SELECT Name FROM people WHERE Nationality != 'Russia'	poker_player	Show names of people whose nationality is not 'Russia'.
SELECT Name FROM people WHERE People_ID NOT IN (SELECT People_ID FROM poker_player)	poker_player	List the names of people that are not poker players.
SELECT count(DISTINCT Nationality) FROM people	poker_player	How many distinct nationalities are there?
SELECT Name FROM country WHERE IndepYear  >  1950	world_1	What are the names of all the countries that became independent after 1950?
SELECT count(*) FROM country WHERE GovernmentForm  =  'Republic'	world_1	How many countries have a republic as their form of government?
SELECT sum(SurfaceArea) FROM country WHERE Region  =  'Caribbean'	world_1	What is the total surface area of the countries in the Caribbean region?
SELECT Continent FROM country WHERE Name  =  'Anguilla'	world_1	Which continent is Anguilla in?
SELECT Region FROM country AS T1 JOIN city AS T2 ON T1.Code  =  T2.CountryCode WHERE T2.Name  =  'Kabul'	world_1	Which region is the city Kabul located in?
SELECT T2.Language FROM country AS T1 JOIN countrylanguage AS T2 ON T1.Code  =  T2.CountryCode WHERE T1.Name  =  'Aruba' ORDER BY Percentage DESC LIMIT 1	world_1	Which language is the most popular in Aruba?
SELECT Population ,  LifeExpectancy FROM country WHERE Name  =  'Brazil'	world_1	What are the population and life expectancies in Brazil?
SELECT Population ,  Region FROM country WHERE Name  =  'Angola'	world_1	What are the region and population of Angola?
SELECT avg(LifeExpectancy) FROM country WHERE Region  =  'Central Africa'	world_1	What is the average expected life expectancy for countries in the region of Central Africa?
SELECT Name FROM country WHERE Continent  =  'Asia' ORDER BY LifeExpectancy LIMIT 1	world_1	What is the name of country that has the shortest life expectancy in Asia?
SELECT sum(Population) ,  max(GNP) FROM country WHERE Continent  =  'Asia'	world_1	What is the total population and maximum GNP in Asia?
SELECT avg(LifeExpectancy) FROM country WHERE Continent  =  'Africa' AND GovernmentForm  =  'Republic'	world_1	What is the average life expectancy in African countries that are republics?
SELECT sum(SurfaceArea) FROM country WHERE Continent  =  'Asia' OR Continent  =  'Europe'	world_1	What is the total surface area of the continents Asia and Europe?
SELECT sum(Population) FROM city WHERE District  =  'Gelderland'	world_1	How many people live in Gelderland district?
SELECT avg(GNP) ,  sum(population) FROM country WHERE GovernmentForm  =  'US Territory'	world_1	What is the average GNP and total population in all nations whose government is US territory?
SELECT count(DISTINCT LANGUAGE) FROM countrylanguage	world_1	How many unique languages are spoken in the world?
SELECT count(DISTINCT GovernmentForm) FROM country WHERE Continent  =  'Africa'	world_1	How many type of governments are in Africa?
SELECT COUNT(T2.Language) FROM country AS T1 JOIN countrylanguage AS T2 ON T1.Code  =  T2.CountryCode WHERE T1.Name  =  'Aruba'	world_1	What is the total number of languages used in Aruba?
SELECT COUNT(*) FROM country AS T1 JOIN countrylanguage AS T2 ON T1.Code  =  T2.CountryCode WHERE T1.Name  =  'Afghanistan' AND IsOfficial  =  'T'	world_1	How many official languages does Afghanistan have?
SELECT T1.Name FROM country AS T1 JOIN countrylanguage AS T2 ON T1.Code  =  T2.CountryCode GROUP BY T1.Name ORDER BY COUNT(*) DESC LIMIT 1	world_1	What is name of the country that speaks the largest number of languages?
SELECT T1.Continent FROM country AS T1 JOIN countrylanguage AS T2 ON T1.Code  =  T2.CountryCode GROUP BY T1.Continent ORDER BY COUNT(*) DESC LIMIT 1	world_1	Which continent has the most diverse languages?
SELECT COUNT(*) FROM (SELECT T1.Name FROM country AS T1 JOIN countrylanguage AS T2 ON T1.Code  =  T2.CountryCode WHERE T2.Language  =  'English' INTERSECT SELECT T1.Name FROM country AS T1 JOIN countrylanguage AS T2 ON T1.Code  =  T2.CountryCode WHERE T2.Language  =  'Dutch') as sub	world_1	How many countries speak both English and Dutch?
SELECT T1.Name FROM country AS T1 JOIN countrylanguage AS T2 ON T1.Code  =  T2.CountryCode WHERE T2.Language  =  'English' INTERSECT SELECT T1.Name FROM country AS T1 JOIN countrylanguage AS T2 ON T1.Code  =  T2.CountryCode WHERE T2.Language  =  'French'	world_1	What are the names of nations speak both English and French?
SELECT T1.Name FROM country AS T1 JOIN countrylanguage AS T2 ON T1.Code  =  T2.CountryCode WHERE T2.Language  =  'English' AND T2.IsOfficial  =  'T' INTERSECT SELECT T1.Name FROM country AS T1 JOIN countrylanguage AS T2 ON T1.Code  =  T2.CountryCode WHERE T2.Language  =  'French' AND T2.IsOfficial  =  'T'	world_1	What are the names of nations where both English and French are official languages?
SELECT COUNT( DISTINCT Continent) FROM country AS T1 JOIN countrylanguage AS T2 ON T1.Code  =  T2.CountryCode WHERE T2.Language  =  'Chinese'	world_1	What is the number of distinct continents where Chinese is spoken?
SELECT DISTINCT T1.Region FROM country AS T1 JOIN countrylanguage AS T2 ON T1.Code  =  T2.CountryCode WHERE T2.Language  =  'English' OR T2.Language  =  'Dutch'	world_1	What are the regions that use English or Dutch?
SELECT * FROM country AS T1 JOIN countrylanguage AS T2 ON T1.Code  =  T2.CountryCode WHERE T2.Language  =  'English' AND IsOfficial  =  'T' UNION SELECT * FROM country AS T1 JOIN countrylanguage AS T2 ON T1.Code  =  T2.CountryCode WHERE T2.Language  =  'Dutch' AND IsOfficial  =  'T'	world_1	What are the countries where either English or Dutch is the official language?
SELECT T2.Language FROM country AS T1 JOIN countrylanguage AS T2 ON T1.Code  =  T2.CountryCode WHERE T1.Continent  =  'Asia' GROUP BY T2.Language ORDER BY COUNT (*) DESC LIMIT 1	world_1	Which language is the most popular on the Asian continent?
SELECT T2.Language FROM country AS T1 JOIN countrylanguage AS T2 ON T1.Code  =  T2.CountryCode WHERE T1.GovernmentForm  =  'Republic' GROUP BY T2.Language HAVING COUNT(*)  =  1	world_1	Which languages are spoken by only one country in republic governments?
SELECT T1.Name ,  T1.Population FROM city AS T1 JOIN countrylanguage AS T2 ON T1.CountryCode  =  T2.CountryCode WHERE T2.Language  =  'English' ORDER BY T1.Population DESC LIMIT 1	world_1	Find the city with the largest population that uses English.
SELECT Name ,  Population ,  LifeExpectancy FROM country WHERE Continent  =  'Asia' ORDER BY SurfaceArea DESC LIMIT 1	world_1	Find the name, population and expected life length of asian country with the largest area?
SELECT avg(LifeExpectancy) FROM country WHERE Name NOT IN (SELECT T1.Name FROM country AS T1 JOIN countrylanguage AS T2 ON T1.Code  =  T2.CountryCode WHERE T2.Language  =  'English' AND T2.IsOfficial  =  'T')	world_1	What is average life expectancy in the countries where English is not the official language?
SELECT sum(Population) FROM country WHERE Name NOT IN (SELECT T1.Name FROM country AS T1 JOIN countrylanguage AS T2 ON T1.Code  =  T2.CountryCode WHERE T2.Language  =  'English')	world_1	What is the total number of people living in the nations that do not use English?
SELECT T2.Language FROM country AS T1 JOIN countrylanguage AS T2 ON T1.Code  =  T2.CountryCode WHERE T1.HeadOfState  =  'Beatrix' AND T2.IsOfficial  =  'T'	world_1	What is the official language spoken in the country whose head of state is Beatrix?
SELECT count(DISTINCT T2.Language) FROM country AS T1 JOIN countrylanguage AS T2 ON T1.Code  =  T2.CountryCode WHERE  IndepYear  <  1930 AND T2.IsOfficial  =  'T'	world_1	What is the total number of unique official languages spoken in the countries that are founded before 1930?
SELECT Name FROM country WHERE SurfaceArea  >  (SELECT min(SurfaceArea) FROM country WHERE Continent  =  'Europe')	world_1	What are the countries that have greater surface area than any country in Europe?
SELECT Name FROM country WHERE Continent  =  'Africa'  AND population  <  (SELECT max(population) FROM country WHERE Continent  =  'Asia')	world_1	What are the African countries that have a  population less than any country in Asia?
SELECT Name FROM country WHERE Continent  =  'Africa'  AND population  <  (SELECT min(population) FROM country WHERE Continent  =  'Asia')	world_1	Which African countries have a smaller population than that of any country in Asia?
SELECT Name FROM country WHERE Continent  =  'Asia'  AND population  >  (SELECT max(population) FROM country WHERE Continent  =  'Africa')	world_1	Which Asian countries have a population that is larger than any country in Africa?
SELECT Name FROM country WHERE Continent  =  'Asia'  AND population  >  (SELECT min(population) FROM country WHERE Continent  =  'Africa')	world_1	What are the Asian countries which have a population larger than that of any country in Africa?
SELECT CountryCode FROM countrylanguage EXCEPT SELECT CountryCode FROM countrylanguage WHERE LANGUAGE  =  'English'	world_1	What are the country codes for countries that do not speak English?
SELECT DISTINCT CountryCode FROM countrylanguage WHERE LANGUAGE != 'English'	world_1	What are the country codes of countries where people use languages other than English?
SELECT Code FROM country WHERE GovernmentForm != 'Republic' EXCEPT SELECT CountryCode FROM countrylanguage WHERE LANGUAGE  =  'English'	world_1	What are the codes of the countries that do not speak English and whose government forms are not Republic?
SELECT DISTINCT T2.Name FROM country AS T1 JOIN city AS T2 ON T2.CountryCode  =  T1.Code WHERE T1.Continent  =  'Europe' AND T1.Name NOT IN (SELECT T3.Name FROM country AS T3 JOIN countrylanguage AS T4 ON T3.Code  =  T4.CountryCode WHERE T4.IsOfficial  =  'T' AND T4.Language  =  'English')	world_1	Which cities are in European countries where English is not the official language?
SELECT DISTINCT T3.Name FROM country AS T1 JOIN countrylanguage AS T2 ON T1.Code  =  T2.CountryCode JOIN city AS T3 ON T1.Code  =  T3.CountryCode WHERE T2.IsOfficial  =  'T' AND T2.Language  =  'Chinese' AND T1.Continent  =  'Asia'	world_1	Whic`h unique cities are in  Asian countries where Chinese is the official language?
SELECT Name ,  SurfaceArea ,  IndepYear FROM country ORDER BY Population LIMIT 1	world_1	What are the name, independence year, and surface area of the country with the smallest population?
SELECT Name ,  population ,  HeadOfState FROM country ORDER BY SurfaceArea DESC LIMIT 1	world_1	What are the population, name and leader of the country with the largest area?
SELECT COUNT(T2.Language) ,  T1.Name FROM country AS T1 JOIN countrylanguage AS T2 ON T1.Code  =  T2.CountryCode GROUP BY T1.Name HAVING COUNT(*)  >=  3	world_1	Return the country name and the numbers of languages spoken for each country that speaks at least 3 languages.
SELECT COUNT(T2.Language) ,  T1.Name FROM country AS T1 JOIN countrylanguage AS T2 ON T1.Code  =  T2.CountryCode GROUP BY T1.Name HAVING COUNT(*)  >  2	world_1	What are the names of countries that speak more than 2 languages, as well as how many languages they speak?
SELECT count(*) ,  District FROM city WHERE Population  >  (SELECT avg(Population) FROM city) GROUP BY District	world_1	Find the number of cities in each district whose population is greater than the average population of cities?
SELECT sum(Population) ,  GovernmentForm FROM country GROUP BY GovernmentForm HAVING avg(LifeExpectancy)  >  72	world_1	Find the government form name and total population for each government form whose average life expectancy is longer than 72.
SELECT sum(Population) ,  avg(LifeExpectancy) ,  Continent FROM country GROUP BY Continent HAVING avg(LifeExpectancy)  <  72	world_1	Find the average life expectancy and total population for each continent where the average life expectancy is shorter than 72?
SELECT Name ,  SurfaceArea FROM country ORDER BY SurfaceArea DESC LIMIT 5	world_1	What are the names and areas of countries with the top 5 largest area?
SELECT Name FROM country ORDER BY Population DESC LIMIT 3	world_1	What are names of countries with the top 3 largest population?
SELECT Name FROM country ORDER BY Population ASC LIMIT 3	world_1	What are the names of the nations with the 3 lowest populations?
SELECT count(*) FROM country WHERE continent  =  'Asia'	world_1	how many countries are in Asia?
SELECT Name FROM country WHERE continent  =  'Europe' AND Population  =  '80000'	world_1	What are the names of the countries that are in the continent of Europe and have a population of 80000?
SELECT sum(Population) ,  avg(SurfaceArea) FROM country WHERE Continent  =  'North America' AND SurfaceArea  >  3000	world_1	What is the total population and average area of countries in the continent of North America whose area is bigger than 3000？
SELECT LANGUAGE FROM countrylanguage GROUP BY LANGUAGE ORDER BY count(*) DESC LIMIT 1	world_1	Which language is spoken by the largest number of countries?
SELECT LANGUAGE ,  CountryCode ,  max(Percentage) FROM countrylanguage GROUP BY CountryCode, Language	world_1	What is the language spoken by the largest percentage of people in each country?
SELECT count(*) ,   max(Percentage) FROM countrylanguage WHERE LANGUAGE  =  'Spanish' GROUP BY CountryCode	world_1	What is the total number of countries where Spanish is spoken by the largest percentage of people?
SELECT CountryCode ,  max(Percentage) FROM countrylanguage WHERE LANGUAGE  =  'Spanish' GROUP BY CountryCode	world_1	What are the codes of countries where Spanish is spoken by the largest percentage of people?
SELECT count(*) FROM conductor	orchestra	How many conductors are there?
SELECT Name FROM conductor ORDER BY Age ASC	orchestra	List the names of conductors in ascending order of age.
SELECT Name FROM conductor WHERE Nationality != 'USA'	orchestra	What are the names of conductors whose nationalities are not 'USA'?
SELECT Record_Company FROM orchestra ORDER BY Year_of_Founded DESC	orchestra	What are the record companies of orchestras in descending order of years in which they were founded?
SELECT avg(Attendance) FROM SHOW	orchestra	What is the average attendance of shows?
SELECT max(SHARE) ,  min(SHARE) FROM performance WHERE TYPE != 'Live final'	orchestra	What are the maximum and minimum share of performances whose type is not 'Live final'.
SELECT count(DISTINCT Nationality) FROM conductor	orchestra	How many different nationalities do conductors have?
SELECT Name FROM conductor ORDER BY Year_of_Work DESC	orchestra	List names of conductors in descending order of years of work.
SELECT Name FROM conductor ORDER BY Year_of_Work DESC LIMIT 1	orchestra	List the name of the conductor with the most years of work.
SELECT T1.Name ,  T2.Orchestra FROM conductor AS T1 JOIN orchestra AS T2 ON T1.Conductor_ID  =  T2.Conductor_ID	orchestra	Show the names of conductors and the orchestras they have conducted.
SELECT T1.Name FROM conductor AS T1 JOIN orchestra AS T2 ON T1.Conductor_ID  =  T2.Conductor_ID GROUP BY T1.Name HAVING COUNT(*)  >  1	orchestra	Show the names of conductors that have conducted more than one orchestras.
SELECT T1.Name FROM conductor AS T1 JOIN orchestra AS T2 ON T1.Conductor_ID  =  T2.Conductor_ID GROUP BY T1.Name ORDER BY COUNT(*) DESC LIMIT 1	orchestra	Show the name of the conductor that has conducted the most number of orchestras.
SELECT T1.Name FROM conductor AS T1 JOIN orchestra AS T2 ON T1.Conductor_ID  =  T2.Conductor_ID WHERE Year_of_Founded  >  2008	orchestra	Please show the name of the conductor that has conducted orchestras founded after 2008.
SELECT Record_Company ,  COUNT(*) FROM orchestra GROUP BY Record_Company	orchestra	Please show the different record companies and the corresponding number of orchestras.
SELECT Major_Record_Format FROM orchestra GROUP BY Major_Record_Format ORDER BY COUNT(*) ASC	orchestra	Please show the record formats of orchestras in ascending order of count.
SELECT Record_Company FROM orchestra GROUP BY Record_Company ORDER BY COUNT(*) DESC LIMIT 1	orchestra	List the record company shared by the most number of orchestras.
SELECT Orchestra FROM orchestra WHERE Orchestra_ID NOT IN (SELECT Orchestra_ID FROM performance)	orchestra	List the names of orchestras that have no performance.
SELECT Record_Company FROM orchestra WHERE Year_of_Founded  <  2003 INTERSECT SELECT Record_Company FROM orchestra WHERE Year_of_Founded  >  2003	orchestra	Show the record companies shared by orchestras founded before 2003 and after 2003.
SELECT COUNT(*) FROM orchestra WHERE Major_Record_Format  =  'CD' OR Major_Record_Format  =  'DVD'	orchestra	Find the number of orchestras whose record format is 'CD' or 'DVD'.
SELECT Year_of_Founded FROM orchestra AS T1 JOIN performance AS T2 ON T1.Orchestra_ID  =  T2.Orchestra_ID GROUP BY T1.Year_of_Founded HAVING COUNT(*)  >  1	orchestra	Show the years in which orchestras that have given more than one performance are founded.
SELECT count(*) FROM high_schooler	network_1	How many high schoolers are there?
SELECT name ,  grade FROM high_schooler	network_1	Show the names and grades of each high schooler.
SELECT grade FROM high_schooler	network_1	Show all the grades of the high schoolers.
SELECT grade FROM high_schooler WHERE name  =  'Kyle'	network_1	What grade is Kyle in?
SELECT name FROM high_schooler WHERE grade  =  10	network_1	Show the names of all high schoolers in grade 10.
SELECT ID FROM high_schooler WHERE name  =  'Kyle'	network_1	Show the ID of the high schooler named Kyle.
SELECT count(*) FROM high_schooler WHERE grade  =  9 OR grade  =  10	network_1	How many high schoolers are there in grade 9 or 10?
SELECT grade ,  count(*) FROM high_schooler GROUP BY grade	network_1	Show the number of high schoolers for each grade.
SELECT grade FROM high_schooler GROUP BY grade ORDER BY count(*) DESC LIMIT 1	network_1	Which grade has the most high schoolers?
SELECT grade FROM high_schooler GROUP BY grade HAVING count(*)  >=  4	network_1	Show me all grades that have at least 4 students.
SELECT student_id ,  count(*) FROM Friend GROUP BY student_id	network_1	Show the student IDs and numbers of friends corresponding to each.
SELECT T2.name ,  count(*) FROM Friend AS T1 JOIN high_schooler AS T2 ON T1.student_id  =  T2.id GROUP BY T2.name	network_1	Show the names of high school students and their corresponding number of friends.
SELECT T2.name FROM Friend AS T1 JOIN high_schooler AS T2 ON T1.student_id  =  T2.id GROUP BY T2.name ORDER BY count(*) DESC LIMIT 1	network_1	What is the name of the high schooler who has the greatest number of friends?
SELECT T2.name FROM Friend AS T1 JOIN high_schooler AS T2 ON T1.student_id  =  T2.id GROUP BY T2.name HAVING count(*)  >=  3	network_1	Show the names of high schoolers who have at least 3 friends.
SELECT T3.name FROM Friend AS T1 JOIN high_schooler AS T2 ON T1.student_id  =  T2.id JOIN high_schooler AS T3 ON T1.friend_id  =  T3.id WHERE T2.name  =  'Kyle'	network_1	Show the names of all of the high schooler Kyle's friends.
SELECT count(*) FROM Friend AS T1 JOIN high_schooler AS T2 ON T1.student_id  =  T2.id WHERE T2.name  =  'Kyle'	network_1	How many friends does the high school student Kyle have?
SELECT id FROM high_schooler EXCEPT SELECT student_id FROM Friend	network_1	Show ids of all students who do not have any friends.
SELECT name FROM high_schooler EXCEPT SELECT T2.name FROM Friend AS T1 JOIN high_schooler AS T2 ON T1.student_id  =  T2.id	network_1	Show names of all high school students who do not have any friends.
SELECT student_id FROM Friend INTERSECT SELECT liked_id FROM Likes	network_1	Show the ids of high schoolers who have friends and are also liked by someone else.
SELECT T2.name FROM Friend AS T1 JOIN high_schooler AS T2 ON T1.student_id  =  T2.id INTERSECT SELECT T2.name FROM Likes AS T1 JOIN high_schooler AS T2 ON T1.liked_id  =  T2.id	network_1	Show name of all students who have some friends and also are liked by someone else.
SELECT student_id ,  count(*) FROM Likes GROUP BY student_id	network_1	Count the number of likes for each student id.
SELECT T2.name ,  count(*) FROM Likes AS T1 JOIN high_schooler AS T2 ON T1.student_id  =  T2.id GROUP BY T2.name	network_1	Show the names of high schoolers who have likes, and numbers of likes for each.
SELECT T2.name FROM Likes AS T1 JOIN high_schooler AS T2 ON T1.student_id  =  T2.id GROUP BY T2.name ORDER BY count(*) DESC LIMIT 1	network_1	What is the name of the high schooler who has the greatest number of likes?
SELECT T2.name FROM Likes AS T1 JOIN high_schooler AS T2 ON T1.student_id  =  T2.id GROUP BY T2.name HAVING count(*)  >=  2	network_1	Show the names of students who have at least 2 likes.
SELECT T2.name FROM Friend AS T1 JOIN high_schooler AS T2 ON T1.student_id  =  T2.id WHERE T2.grade  >  5 GROUP BY T2.name HAVING count(*)  >=  2	network_1	Show the names of students who have a grade higher than 5 and have at least 2 friends.
SELECT count(*) FROM Likes AS T1 JOIN high_schooler AS T2 ON T1.student_id  =  T2.id WHERE T2.name  =  'Kyle'	network_1	How many likes does Kyle have?
SELECT avg(grade) FROM high_schooler WHERE id IN (SELECT T1.student_id FROM Friend AS T1 JOIN high_schooler AS T2 ON T1.student_id  =  T2.id)	network_1	Find the average grade of all students who have some friends.
SELECT min(grade) FROM high_schooler WHERE id NOT IN (SELECT T1.student_id FROM Friend AS T1 JOIN high_schooler AS T2 ON T1.student_id  =  T2.id)	network_1	Find the minimum grade of students who have no friends.
SELECT state FROM Owners INTERSECT SELECT state FROM Professionals	dog_kennels	Which states have both owners and professionals living there?
SELECT avg(age) FROM Dogs WHERE dog_id IN ( SELECT dog_id FROM Treatments )	dog_kennels	What is the average age of the dogs who have gone through any treatments?
SELECT professional_id ,  last_name ,  cell_number FROM Professionals WHERE state  =  'Indiana' UNION SELECT T1.professional_id ,  T1.last_name ,  T1.cell_number FROM Professionals AS T1 JOIN Treatments AS T2 ON T1.professional_id  =  T2.professional_id GROUP BY T1.professional_id HAVING count(*)  >  2	dog_kennels	Which professionals live in the state of Indiana or have done treatment on more than 2 treatments? List his or her id, last name and cell phone.
SELECT name FROM Dogs WHERE dog_id NOT IN( SELECT dog_id FROM Treatments GROUP BY dog_id HAVING sum(cost_of_treatment)  >  1000 )	dog_kennels	Which dogs have not cost their owner more than 1000 for treatment? List the dog names.
SELECT first_name FROM Professionals UNION SELECT first_name FROM Owners EXCEPT SELECT name FROM Dogs	dog_kennels	Which first names are used for professionals or owners but are not used as dog names?
SELECT professional_id ,  role_code ,  email_address FROM Professionals EXCEPT SELECT T1.professional_id ,  T1.role_code ,  T1.email_address FROM Professionals AS T1 JOIN Treatments AS T2 ON T1.professional_id  =  T2.professional_id	dog_kennels	Which professional did not operate any treatment on dogs? List the professional's id, role and email.
SELECT T1.owner_id ,  T2.first_name ,  T2.last_name FROM Dogs AS T1 JOIN Owners AS T2 ON T1.owner_id  =  T2.owner_id GROUP BY T1.owner_id, T2.first_name, T2.last_name ORDER BY count(*) DESC LIMIT 1	dog_kennels	Which owner owns the most dogs? List the owner id, first name and last name.
SELECT T1.professional_id ,  T1.role_code ,  T1.first_name FROM Professionals AS T1 JOIN Treatments AS T2 ON T1.professional_id  =  T2.professional_id GROUP BY T1.professional_id HAVING count(*)  >=  2	dog_kennels	Which professionals have done at least two treatments? List the professional's id, role, and first name.
SELECT T1.breed_name FROM Breeds AS T1 JOIN Dogs AS T2 ON T1.breed_code  =  T2.breed_code GROUP BY T1.breed_name ORDER BY count(*) DESC LIMIT 1	dog_kennels	What is the name of the breed with the most dogs?
SELECT T1.owner_id ,  T1.last_name FROM Owners AS T1 JOIN Dogs AS T2 ON T1.owner_id  =  T2.owner_id JOIN Treatments AS T3 ON T2.dog_id  =  T3.dog_id GROUP BY T1.owner_id ORDER BY count(*) DESC LIMIT 1	dog_kennels	Which owner has paid for the most treatments on his or her dogs? List the owner id and last name.
SELECT T1.treatment_type_description FROM Treatment_types AS T1 JOIN Treatments AS T2 ON T1.treatment_type_code  =  T2.treatment_type_code GROUP BY T1.treatment_type_code ORDER BY sum(cost_of_treatment) ASC LIMIT 1	dog_kennels	What is the description of the treatment type that costs the least money in total?
SELECT T1.owner_id ,  T1.zip_code FROM Owners AS T1 JOIN Dogs AS T2 ON T1.owner_id  =  T2.owner_id JOIN Treatments AS T3 ON T2.dog_id  =  T3.dog_id GROUP BY T1.owner_id ORDER BY sum(T3.cost_of_treatment) DESC LIMIT 1	dog_kennels	Which owner has paid the largest amount of money in total for their dogs? Show the owner id and zip code.
SELECT T1.professional_id ,  T1.cell_number FROM Professionals AS T1 JOIN Treatments AS T2 ON T1.professional_id  =  T2.professional_id GROUP BY T1.professional_id HAVING count(*)  >=  2	dog_kennels	Which professionals have done at least two types of treatments? List the professional id and cell phone.
SELECT DISTINCT T1.first_name ,  T1.last_name FROM Professionals AS T1 JOIN Treatments AS T2 ON T1.professional_id = T2.professional_id WHERE cost_of_treatment  <  (SELECT avg(cost_of_treatment) FROM Treatments );	dog_kennels	What are the first name and last name of the professionals who have done treatment with cost below average?
SELECT T1.date_of_treatment ,  T2.first_name FROM Treatments AS T1 JOIN Professionals AS T2 ON T1.professional_id  =  T2.professional_id	dog_kennels	List the date of each treatment, together with the first name of the professional who operated it.
SELECT T1.cost_of_treatment ,  T2.treatment_type_description FROM Treatments AS T1 JOIN treatment_types AS T2 ON T1.treatment_type_code  =  T2.treatment_type_code	dog_kennels	List the cost of each treatment and the corresponding treatment type description.
SELECT T1.first_name ,  T1.last_name ,  T2.size_code FROM Owners AS T1 JOIN Dogs AS T2 ON T1.owner_id  =  T2.owner_id	dog_kennels	List each owner's first name, last name, and the size of his for her dog.
SELECT T1.first_name ,  T2.name FROM Owners AS T1 JOIN Dogs AS T2 ON T1.owner_id  =  T2.owner_id	dog_kennels	List pairs of the owner's first name and the dogs's name.
SELECT T1.name ,  T2.date_of_treatment FROM Dogs AS T1 JOIN Treatments AS T2 ON T1.dog_id  =  T2.dog_id WHERE T1.breed_code  =  ( SELECT breed_code FROM Dogs GROUP BY breed_code ORDER BY count(*) ASC LIMIT 1 )	dog_kennels	List the names of the dogs of the rarest breed and the treatment dates of them.
SELECT T1.first_name ,  T2.name FROM Owners AS T1 JOIN Dogs AS T2 ON T1.owner_id  =  T2.owner_id WHERE T1.state  =  'Virginia'	dog_kennels	Which dogs are owned by someone who lives in Virginia? List the owner's first name and the dog's name.
SELECT DISTINCT T1.date_arrived ,  T1.date_departed FROM Dogs AS T1 JOIN Treatments AS T2 ON T1.dog_id  =  T2.dog_id	dog_kennels	What are the arriving date and the departing date of the dogs who have gone through a treatment?
SELECT T1.last_name FROM Owners AS T1 JOIN Dogs AS T2 ON T1.owner_id  =  T2.owner_id WHERE T2.age  =  ( SELECT max(age) FROM Dogs )	dog_kennels	List the last name of the owner owning the youngest dog.
SELECT email_address FROM Professionals WHERE state  =  'Hawaii' OR state  =  'Wisconsin'	dog_kennels	List the emails of the professionals who live in the state of Hawaii or the state of Wisconsin.
SELECT date_arrived ,  date_departed FROM Dogs	dog_kennels	What are the arriving date and the departing date of all the dogs?
SELECT count(DISTINCT dog_id) FROM Treatments	dog_kennels	How many dogs went through any treatments?
SELECT count(DISTINCT professional_id) FROM Treatments	dog_kennels	How many professionals have performed any treatment to dogs?
SELECT role_code ,  street ,  city ,  state FROM professionals WHERE city LIKE '%West%'	dog_kennels	Which professionals live in a city containing the substring 'West'? List his or her role, street, city and state.
SELECT first_name ,  last_name ,  email_address FROM Owners WHERE state LIKE '%North%'	dog_kennels	Which owners live in the state whose name contains the substring 'North'? List his first name, last name and email.
SELECT count(*) FROM Dogs WHERE age  <  ( SELECT avg(age) FROM Dogs )	dog_kennels	How many dogs have an age below the average?
SELECT cost_of_treatment FROM Treatments ORDER BY date_of_treatment DESC LIMIT 1	dog_kennels	How much does the most recent treatment cost?
SELECT count(*) FROM Dogs WHERE dog_id NOT IN ( SELECT dog_id FROM Treatments )	dog_kennels	How many dogs have not gone through any treatment?
SELECT count(*) FROM Owners WHERE owner_id NOT IN ( SELECT owner_id FROM Dogs )	dog_kennels	How many owners temporarily do not have any dogs?
SELECT count(*) FROM Professionals WHERE professional_id NOT IN ( SELECT professional_id FROM Treatments )	dog_kennels	How many professionals did not operate any treatment on dogs?
SELECT name ,  age ,  weight FROM Dogs WHERE abandoned_yn  =  '1'	dog_kennels	List the dog name, age and weight of the dogs who have been abandoned? 1 stands for yes, and 0 stands for no.
SELECT avg(age) FROM Dogs	dog_kennels	What is the average age of all the dogs?
SELECT max(age) FROM Dogs	dog_kennels	What is the age of the oldest dog?
SELECT charge_type ,  charge_amount FROM Charges	dog_kennels	How much does each charge type costs? List both charge type and amount.
SELECT max(charge_amount) FROM Charges	dog_kennels	How much does the most expensive charge type costs?
SELECT email_address ,  cell_number ,  home_phone FROM professionals	dog_kennels	List the email, cell phone and home phone of all the professionals.
SELECT DISTINCT breed_code ,  size_code FROM dogs	dog_kennels	What are all the possible breed type and size type combinations?
SELECT DISTINCT T1.first_name ,  T3.treatment_type_description FROM professionals AS T1 JOIN Treatments AS T2 ON T1.professional_id  =  T2.professional_id JOIN Treatment_types AS T3 ON T2.treatment_type_code  =  T3.treatment_type_code	dog_kennels	List the first name of all the professionals along with the description of the treatment they have done.
SELECT count(*) FROM singer	singer	How many singers are there?
SELECT Name FROM singer ORDER BY Net_Worth_Millions ASC	singer	List the name of singers in ascending order of net worth.
SELECT Birth_Year ,  Citizenship FROM singer	singer	What are the birth year and citizenship of singers?
SELECT Name FROM singer WHERE Citizenship != 'France'	singer	List the name of singers whose citizenship is not 'France'.
SELECT Name FROM singer WHERE Birth_Year  =  1948 OR Birth_Year  =  1949	singer	Show the name of singers whose birth year is either 1948 or 1949?
SELECT Name FROM singer ORDER BY Net_Worth_Millions DESC LIMIT 1	singer	What is the name of the singer with the largest net worth?
SELECT Citizenship ,  COUNT(*) FROM singer GROUP BY Citizenship	singer	Show different citizenship of singers and the number of singers of each citizenship.
SELECT Citizenship FROM singer GROUP BY Citizenship ORDER BY COUNT(*) DESC LIMIT 1	singer	Please show the most common citizenship of singers.
SELECT Citizenship ,  max(Net_Worth_Millions) FROM singer GROUP BY Citizenship	singer	Show different citizenships and the maximum net worth of singers of each citizenship.
SELECT T2.Title ,  T1.Name FROM singer AS T1 JOIN song AS T2 ON T1.Singer_ID  =  T2.Singer_ID	singer	Show titles of songs and names of singers.
SELECT DISTINCT T1.Name FROM singer AS T1 JOIN song AS T2 ON T1.Singer_ID  =  T2.Singer_ID WHERE T2.Sales  >  300000	singer	Show distinct names of singers that have songs with sales more than 300000.
SELECT T1.Name FROM singer AS T1 JOIN song AS T2 ON T1.Singer_ID  =  T2.Singer_ID GROUP BY T1.Name HAVING COUNT(*)  >  1	singer	Show the names of singers that have more than one song.
SELECT T1.Name ,  sum(T2.Sales) FROM singer AS T1 JOIN song AS T2 ON T1.Singer_ID  =  T2.Singer_ID GROUP BY T1.Name	singer	Show the names of singers and the total sales of their songs.
SELECT Name FROM singer WHERE Singer_ID NOT IN (SELECT Singer_ID FROM song)	singer	List the name of singers that do not have any song.
SELECT Citizenship FROM singer WHERE Birth_Year  <  1945 INTERSECT SELECT Citizenship FROM singer WHERE Birth_Year  >  1955	singer	Show the citizenship shared by singers with birth year before 1945 and after 1955.
SELECT count(*) FROM Other_Available_Features	real_estate_properties	How many available features are there in total?
SELECT T2.feature_type_name FROM other_available_features AS T1 JOIN reference_feature_types AS T2 ON T1.feature_type_code  =  T2.feature_type_code WHERE T1.feature_name  =  'AirCon'	real_estate_properties	What is the feature type name of feature AirCon?
SELECT T2.property_type_description FROM properties AS T1 JOIN reference_property_types AS T2 ON T1.property_type_code  =  T2.property_type_code GROUP BY T2.property_type_description	real_estate_properties	Show the property type descriptions of properties belonging to that code.
SELECT property_name FROM Properties WHERE property_type_code  =  'House' UNION SELECT property_name FROM Properties WHERE property_type_code  =  'Apartment' AND room_count  >  1	real_estate_properties	What are the names of properties that are either houses or apartments with more than 1 room?
